RICO,X,Male,24-08-2005,rico_x@gmail.com,dd5ddb97fe4bf7017d4bf5382976fd15,91-9274553671,6,27,82,109,41,9,50
Jivika,T,Female,15-04-2009,jivika_169@gmail.com,c5d03207886ef650576f4abbec954b91,91-8139513444,3,71,4,75,1,9,10
Harmya,FARRON,Female,10-07-2011,harmya_328@gmail.com,d45607c6eb65ee66c379994cbb757318,91-7588643169,13,3,96,99,22,3,25
Sarika,EDMUND,Female,15-11-2009,sarika_148@gmail.com,52e71214a6df91a38b9e003cb6396077,91-7342428771,44,7,7,14,13,3,16
Noor,SEVE,Female,29-11-2008,seve_892@gmail.com,4f754c486392731cc7e6b28dbb9630e7,91-7337833978,17,92,3,95,31,1,32
KAMANI,G,Male,06-11-2009,kamani@gmail.com,279b2a653daefb8b409b385744b1ce33,91-7963777712,9,89,33,122,3,34,37
Anandalakshmi,ZAIRE,Female,19-03-2007,zaire_791@gmail.com,abd26589b10a133ef2857b7916eab111,91-7477828764,7,2,27,29,4,1,5
GUSTAW,L,Male,12-04-2012,gustaw_l@yahoo.in,6b880953b58ead553f4cd28c779d43b4,91-9366979494,13,38,45,83,2,1,3
Prapti,K,Female,16-09-2007,prapti_591@yahoo.in,234e450cd447a5f5cbe868922c6c779c,91-9476116853,85,8,6,14,36,54,90
Vibhishan,O,Male,2006-0-24,o_927@gmail.com,9d673575988cb34ea0025c11f302fc1d,91-8178229998,2,34,84,118,8,4,12
Chinmayi,Sheetal,Female,03-06-2006,chinmayi_sheetal_687@yahoo.in,abc0d6263d8fa33894a16446f3944734,NA,0,0,0,0,0,0,0
MEHTAB,ZAKRIYA,Male,20-07-2013,zakriya@gmail.com,1cf8c6ece628c415932ab61fd6defebb,91-9617465895,2,53,12,65,8,42,50
Manisha,M,Female,19-05-2012,manisha_m@gmail.com,49e720bd461b11b6482320c284ced5ff,91-7293979235,88,5,2,7,44,23,67
Harsha,Badriprasad,Female,20-04-2013,badriprasad_397@gmail.com,d087f3a5e12eb89eef14d511bf8884f7,NA,0,0,0,0,0,0,0
Tusti,DEVYN,Female,04-05-2009,tusti_devyn@gmail.com,bc965157dabf0a8cc741961d7fc9f906,91-8678951916,2,2,4,6,9,99,108
Abhinabhas,I,Male,14-03-2013,abhinabhas_i@yahoo.in,c5e8b5f4092195c579cd876b45ce6aaf,91-9445841367,8,15,57,72,17,6,23
Nandana,P,Female,09-04-2011,nandana_p@yahoo.in,7039534a3cd0caee28f09621ee72d780,91-7393965339,95,25,84,109,25,4,29
TAYLOR,Samiran,Male,24-09-2010,taylor_634@gmail.com,93b2de2ca88b9f42655ca54eb74ac51b,91-8647967242,5,4,71,75,67,4,71
Krithya,F,Female,25-03-2011,krithya_f@gmail.com,b93309e2fb5bcdba43e57e3d00a8edd8,91-7585282248,39,65,17,82,8,8,16
Nita,P,Female,24-03-2014,nita_286@yahoo.in,e214aea95aa3a93abb6013a66694e416,NA,0,0,0,0,0,0,0
Sriya,Namasyu,Female,2009-0-29,sriya_namasyu_216@yahoo.in,bb7a4f40bc3e47cbc1321c79cc0805bb,NA,0,0,0,0,0,0,0
Ashakiran,ALEXANDER-JAMES,Female,19-08-2012,alexander-james@gmail.com,fb2cbf1180e40b7427ece4b7846cb3c0,91-7297165522,84,47,7,54,1,22,23
Chitraksh,J,Male,11-07-2006,chitraksh_j_418@gmail.com,7124f2880fb838cbb3fedcd2e6144e16,91-7274882649,37,7,9,16,68,3,71
KINGSTON,C,Male,2005-0-16,kingston_c@gmail.com,b19d84987975b3b0cc02257ab253445c,91-9344158515,54,77,2,79,8,1,9
LAKAI,BRETT,Male,2006-0-3,lakai_brett@gmail.com,07b3e67a940104a56ab99231197e63d9,91-7349534546,9,4,6,10,4,95,99
AARAN,SEBASTIEN,Male,19-06-2005,sebastien_376@gmail.com,8947a7aa9085fbc766be36b08647090b,91-7727121984,82,2,32,34,2,19,21
MIKEY,W,Male,15-08-2011,mikey_w@gmail.com,81625c5462993a928a9b01f92422ea1c,91-8543977659,7,2,29,31,9,91,100
Nauka,PRANAY,Female,05-09-2011,nauka_pranay_459@gmail.com,057f0369db4d2a9b1e7a8629c815dc29,91-8861742358,66,8,3,11,7,14,21
Dhawal,RAYHAAN,Male,17-10-2009,dhawal@gmail.com,6c12fc44ec2fc18f4351f3303089b8cb,91-7913884356,82,5,46,51,21,11,32
Varada,V,Female,29-07-2010,varada_v_174@gmail.com,04f9be1364eca373938b239737748592,NA,0,0,0,0,0,0,0
SHIVEN,H,Male,03-07-2013,shiven_789@gmail.com,18bb5008e0cf8f92eba2483872d74423,91-8853474842,92,79,59,138,16,4,20
Sulalita,CAMDEN,Female,10-11-2005,sulalita_camden@gmail.com,bf3f5a653f73977d9c26907c7000c1f4,91-7139469288,2,7,3,10,41,85,126
Gangaor Gangotri,H,Female,2013-0-31,gangaor gangotri_263@gmail.com,8ef3298b8216d5080086c576518458db,NA,0,0,0,0,0,0,0
Saparna,J,Female,27-02-2010,saparna_j_497@gmail.com,e8bd250210c7b0377a852e3e54ec593f,91-9578713936,68,2,21,23,1,96,97
Marudham,K,Female,29-09-2011,marudham_k_841@yahoo.in,402a1253cc48ba09de81091693bd4b17,91-7681381148,69,2,2,4,5,9,14
ARJAN,Jusal,Male,13-01-2005,arjan_jusal@gmail.com,3c2f61d820767ce6d17e64a2482e9177,91-8753171793,48,48,5,53,9,28,37
Balamohan,INIGO,Male,2010-0-20,inigo@yahoo.in,3addd273eb0e8ba57b018a07ddc41190,91-7847429489,81,1,6,7,7,83,90
Omana,X,Female,26-04-2007,omana_x@gmail.com,f233d3b6a8f978f84342aae3779a3599,91-9343577481,3,2,9,11,36,3,39
PRIYAN,ALEXAVIER,Male,23-07-2005,priyan_alexavier@gmail.com,8fa6a1891ec121177b5a556b71203a63,91-9418757198,4,8,4,12,62,9,71
Jagachandra,U,Male,21-07-2012,jagachandra@gmail.com,f6b7dfc2c4397c7cb111019421c66e85,91-7258414971,81,1,86,87,6,48,54
AYMEN,ILYAAS,Male,21-08-2004,aymen_ilyaas_513@yahoo.in,c217e7135be219ca20109b85fc0bcc8a,NA,0,0,0,0,0,0,0
NAVID,W,Male,2005-0-11,w@gmail.com,14dd39a6ee6ad48051a555a2ad3aff8f,91-8311714457,53,3,8,11,8,7,15
ZAYDAN,X,Male,2011-0-4,zaydan_x_231@gmail.com,85a66d515850e0a5ef475c24447816ed,NA,0,0,0,0,0,0,0
OSCAR,A,Male,29-10-2008,oscar_a@gmail.com,9a413f1f1bfea279b8dcbbfcf19171d6,91-7547219482,44,3,86,89,3,78,81
Durvaor Durba,N,Female,02-01-2009,durvaor durba_n_194@yahoo.in,572de11e98ea605f971e07cdd327c333,91-9637429213,22,5,87,92,38,61,99
Pratishtha,TREMAINE,Female,04-10-2010,pratishtha_tremaine_382@gmail.com,f838f45180b5ba16c3ccf946823d6a4e,91-9421347691,1,35,82,117,54,43,97
Shyamlata,JERRY,Female,2006-0-4,shyamlata_jerry@gmail.com,6c7d93c57f031cc44aefacea8380a042,NA,0,0,0,0,0,0,0
SANTHOSH,A,Male,07-10-2014,santhosh_a@yahoo.in,852250fa21a982caaeacd98b02dfc835,91-8517894933,18,3,7,10,14,9,23
SETH,Q,Male,02-03-2006,seth_q_167@gmail.com,af1db26d492173a1c13e4a249da136d1,91-7192121768,5,4,75,79,74,58,132
Sunetra,LORD,Female,28-08-2011,sunetra@gmail.com,c0a1b9dce97eb661adb48b1c5a660bce,91-7485363499,62,7,94,101,95,17,112
LIVIO,Hemang,Male,14-11-2013,livio_hemang_293@yahoo.in,208fa17801431911852f85d2d00623ab,91-8298766652,71,5,57,62,25,23,48
TYLAN,Apparajito,Male,12-07-2014,tylan_apparajito@gmail.com,fbac3861421a04c168fe417e94c4a360,91-8375312937,89,5,18,23,8,1,9
Rajat,Vajramani,Male,05-06-2009,rajat_768@gmail.com,4cc7ec9aaabfba23332845598cd6c31a,91-8382827396,78,39,39,78,29,1,30
Madhulata,Y,Female,27-05-2009,madhulata@gmail.com,12f5ad0d120cad8b876934905d083b28,91-7529587368,2,77,93,170,59,4,63
Kanchan,CHARLY,Female,08-11-2012,charly@gmail.com,c4933ca23c21bec4c423c3bf4ca063b4,NA,0,0,0,0,0,0,0
Sai,D,Female,10-10-2011,d_236@gmail.com,ba0028f0da76c3f5f185f0ebf1c16f80,91-9795863852,19,2,4,6,73,86,159
Urmila,CORBEN,Female,21-04-2013,urmila_corben@yahoo.in,bfa38b92cb846fb020684899454e146a,91-9845568394,4,9,9,18,3,2,5
Shevanti,Q,Female,22-02-2014,q@yahoo.in,67feafb252647843ab8759e073e6087a,91-8372871144,98,4,17,21,8,58,66
Aruna,KELECHI,Female,01-10-2008,aruna_kelechi@gmail.com,33c3649daf1fdbcbe01929c78be420b5,91-7592437239,2,71,1,72,4,9,13
RUO,MATEJ,Male,28-01-2004,ruo_matej_539@yahoo.in,47fe5b1cf1aa7af690c744adccf52fa3,91-7662234362,46,2,8,10,6,8,14
Sankari,ABUL,Female,30-07-2013,sankari@gmail.com,7610e22346247a3d4749c1170ea254da,91-9977976662,5,57,97,154,76,83,159
Jitendra,W,Male,25-04-2008,jitendra_w_483@gmail.com,8f294d3da210cbfc0e3afd40e481d85f,91-9174644458,94,78,57,135,6,6,12
Trupti,V,Female,19-11-2007,trupti_v_956@gmail.com,3c187580531f2b0e5a8675bc5cb67a45,91-8642579875,33,8,93,101,25,3,28
BOSTON,B,Male,21-02-2007,boston_b@gmail.com,252be354406fbad7c1360330f7e16d82,91-7623935775,5,86,26,112,1,6,7
Sacchidananda,O,Male,05-09-2006,sacchidananda_o@gmail.com,9dc6cffdbd42169b65515e13f30ee5f7,91-8342579214,99,1,8,9,62,86,148
Tanaya,RYLEA,Female,05-01-2013,tanaya_rylea_649@yahoo.in,f341f9477cd9e42e79afb918431b8e61,NA,0,0,0,0,0,0,0
SHERIFF,G,Male,09-10-2005,g_157@gmail.com,6f667c7d7bee75b59f413068fd010f67,91-9748789269,2,8,47,55,29,32,61
Vasanta,DALEY,Female,2012-0-11,vasanta_daley@yahoo.in,0ce5f7cb46b38727928e8f56cd7b373e,NA,0,0,0,0,0,0,0
MARLOWE,JOHN-JOE,Male,07-01-2013,marlowe_839@yahoo.in,73d71067b5d37376b097536e468902e6,91-9318122629,4,4,78,82,9,78,87
DILLON,L,Male,08-10-2009,dillon_891@gmail.com,3abd011e69736d3af481e926e7782691,91-7611964334,5,5,69,74,89,7,96
Sushma,Q,Female,20-10-2013,sushma_q_692@gmail.com,39ddb45974ad1a6c70808ff1c16701d6,91-9435997146,1,65,9,74,92,4,96
CHESNEY,M,Male,02-03-2010,m@gmail.com,a5c80375a8e3225786f38d58c8e4efb7,91-9521786673,38,63,28,91,3,3,6
Chandanika,Palashkusum,Female,03-03-2012,chandanika_625@gmail.com,4c91f172f77e8bd20043687e3de6e2f0,91-7533962359,57,1,52,53,5,14,19
Nandita,Abhay,Female,2012-4-31,nandita_abhay_812@gmail.com,b691dd9f5320a83b01821b7584eed46f,91-8371537336,5,22,17,39,8,32,40
TAHMID,O,Male,26-08-2011,o@yahoo.in,eb80de33a7811b5d327745eb545a4a6f,91-7747112954,79,11,14,25,2,3,5
Treya,KARANDEEP,Female,09-03-2005,treya@gmail.com,7dd93891c5d227413ba97c1c99fdbbf4,91-9927723874,3,1,44,45,57,81,138
Akalka,L,Female,2004-0-3,akalka@yahoo.in,68b610fca7ba3d01104bc65af53eb74f,91-9318589345,46,18,96,114,26,8,34
Mehal,RAJAB,Female,05-01-2013,mehal_579@gmail.com,3faf824b017df6d5a7c4e243039d3de8,91-7176278529,5,54,6,60,4,6,10
Mitali,Keshav,Female,19-10-2010,mitali_keshav_329@gmail.com,ff780ab7cadaa8188ef097b7f175ac98,91-9843152223,13,61,8,69,57,65,122
Sarala,J,Female,20-09-2010,j@yahoo.in,94565ddfdc980d3af65731c26e771b14,91-9352648188,4,66,3,69,2,36,38
Sohalia,I,Female,26-07-2005,sohalia_i_921@gmail.com,bb0a930d780a1860dde9694d8cca83dc,91-7296641239,32,8,7,15,34,7,41
LYON,H,Male,21-07-2009,h@yahoo.in,8308d6ace45a2a8a91fb66dd72baf854,91-8689799763,69,3,87,90,49,4,53
Mrudani,Q,Female,22-07-2007,mrudani_q_438@yahoo.in,9320d54546073fda00d549063e7d8bb1,91-8989955581,7,69,4,73,93,64,157
MICHAL,P,Male,2006-0-24,p_947@gmail.com,1d90196019ff0149280f6fd03bfe6b12,91-8352791631,95,67,38,105,69,96,165
Hemangi,N,Female,05-02-2005,n_951@yahoo.in,dd18efb843a37dbfff2e8d613aef8db4,91-8327454269,19,2,4,6,6,9,15
ARYAN,LAYSON,Male,18-08-2007,aryan_layson@gmail.com,e58a9a245ee0719ea777f672b7b0db66,91-9183874775,76,4,7,11,96,95,191
Dhriti,I,Female,20-04-2012,i_184@gmail.com,b39827b185430f023973c4302e8ee5ca,NA,0,0,0,0,0,0,0
Mena,Praver,Female,21-08-2010,mena@gmail.com,30ce4d10030afe56586709867b9d9f51,91-7285817421,25,78,4,82,8,85,93
Roshan,G,Female,03-01-2012,roshan@gmail.com,6314766f37fe82b2041c64d12c2391f9,91-9218116967,5,3,83,86,8,3,11
Kanta,PARAMVEER,Female,14-06-2007,paramveer_824@yahoo.in,84e938fbd59296603690b8be54012ab3,91-8968845628,62,77,13,90,3,6,9
Adhira,DAI,Female,2007-0-24,dai_275@gmail.com,b3ddbfc7fcb93c9f05668521767af0ac,91-7673266434,3,1,31,32,52,78,130
KAEDEN,N,Male,16-03-2006,kaeden_n@gmail.com,15f49643195ca51d0939e954b4e84000,91-9594952361,69,79,49,128,75,56,131
KAYLUB,S,Male,06-01-2010,kaylub_s@gmail.com,43b24e05c917ff9209d9d0e32f29b33a,91-7238823739,8,73,4,77,93,31,124
Navrang,O,Male,27-01-2006,navrang_139@yahoo.in,2a8188f176248a855ff6e5223ee676f7,91-7919536893,3,7,3,10,62,8,70
Jeevan,RAFAL,Male,01-01-2012,jeevan@yahoo.in,54e345e4284298d0945aeb6c35aefc6f,91-7833924724,89,17,2,19,99,88,187
AARISH,N,Male,11-07-2007,n@gmail.com,61511324ff417264577c32651610b455,NA,0,0,0,0,0,0,0
Farukhor Farokh ,MASUM,Male,15-10-2011,farukhor farokh _masum@gmail.com,cef6b32d4b3387121e71509b9d85ffff,91-9553843819,25,4,33,37,4,33,37
Jithya,Aalap,Female,14-05-2011,jithya_658@gmail.com,f7e53fbbccb4edb702ae1fed27112939,91-8298354113,44,4,5,9,31,8,39
BROOKS,Subhan,Male,23-01-2011,brooks_subhan_816@gmail.com,4bcd7235f4699aa977d03d4f52579bd3,91-7136526939,4,83,17,100,2,6,8
Ekanthika,U,Female,2005-6-31,ekanthika_u@gmail.com,d5b3c1def2d916bc9f9869467c2d36f5,91-9139475576,2,48,44,92,3,79,82
Pradyot,X,Male,04-07-2008,x@gmail.com,4c403f7787b95ff93e21d98a777b4b89,91-7482472529,83,84,8,92,4,7,11
Chakradev,G,Male,16-10-2006,g@gmail.com,3724a26e5ab6278ce035ea7009423624,91-7756614117,4,73,88,161,4,9,13
Deepti,PRATHAM,Female,06-08-2008,deepti_726@gmail.com,9563d59012e80f79b0f22b4c63188dd1,91-7958764168,4,67,1,68,51,2,53
Kunja,MARTYNAS,Male,28-03-2012,kunja_983@gmail.com,30471d9ad39f19161f210b2c7f419b4f,91-7362964766,4,3,3,6,1,9,10
JAPNOOR,W,Male,2005-0-20,w@gmail.com,7bd8633f5925f8790fbe0a3d14f23757,91-7435267939,92,77,11,88,59,91,150
ABDUL-SAMI,DAMION,Male,13-05-2010,abdul-sami_damion_469@gmail.com,2e28836b07f59f93c1807d1fe459ae7e,91-7822696662,64,9,99,108,5,88,93
Chandrak,ANSELM,Male,05-11-2012,anselm_173@gmail.com,d1f68fcb6d278b0487655e71347f661b,91-8275624217,6,13,39,52,72,12,84
Jayaprada,TOMMY-JOE,Female,24-04-2011,jayaprada@yahoo.in,5664030cbd25d220952ca15957af8891,91-7744372793,33,9,39,48,51,6,57
KONOR,P,Male,23-05-2009,p_246@gmail.com,9d9e331dc54769de7421118a0c5bdb3d,91-9843311744,2,7,5,12,77,4,81
Mahitha,Hemamdar,Female,07-07-2006,mahitha_152@gmail.com,582d1846190e304a5c5f0c7f5f64adfc,91-8628813267,34,33,92,125,5,6,11
MATVIY,RYLEIGH,Male,16-09-2008,matviy@yahoo.in,81bb1d5da874c734b86f2e5f39905cac,91-9621779733,2,92,6,98,53,37,90
JOHN-JOE,MEKAI,Male,29-08-2007,john-joe_mekai@yahoo.in,b33ab7da67fdeda8e544df87731b4f66,91-7976788293,7,56,1,57,2,7,9
Shalini,KAVEL,Female,05-04-2012,kavel_894@gmail.com,e8d7763a5acf440e57492a7606bb679e,NA,0,0,0,0,0,0,0
Alok,ASVIN,Male,27-09-2014,alok_asvin@gmail.com,28de1d85277507778fbc9c078c6679c0,91-7278333515,6,96,1,97,38,4,42
HUEY,S,Male,2005-0-20,huey_391@gmail.com,422a0fcadc5a68ea7c6c2d12deb65d18,NA,0,0,0,0,0,0,0
Hemakshi,N,Female,2011-6-31,hemakshi@gmail.com,bbb0b17c33883274f947f397d02fc21d,91-7452198645,85,81,5,86,11,44,55
Dhawal,Saleem,Male,08-10-2006,saleem_218@gmail.com,692e6d7c960fdae5ab562f73c883aaae,91-7623987387,2,8,69,77,2,7,9
Naganika,A,Female,25-02-2008,naganika_931@gmail.com,5b9415a693350294b7ce52eaa8556b1c,91-7627111654,1,7,4,11,17,55,72
Bhanuja,JACUB,Female,19-06-2012,bhanuja_jacub@gmail.com,8f11022a705d0cc2f38306503ca60965,91-9265991422,6,5,6,11,89,6,95
Vikramaditya,K,Male,09-03-2012,vikramaditya_k@gmail.com,a57cc0ca238ef3439765f66a16b3edb2,91-7531527525,7,98,2,100,9,1,10
Bhagirath,S,Male,14-10-2004,bhagirath_s_623@yahoo.in,13175ebb0a0b4bf56b521bdc996d06e0,91-9863533389,2,27,23,50,4,8,12
METE,X,Male,07-06-2013,mete_x@gmail.com,5592d13e90c482d095ce294b8abbf04c,91-7583381579,2,55,2,57,78,42,120
Kusumavati,U,Female,26-04-2011,u@yahoo.in,bee695d8aa52261a1d090131fd59d215,91-9664273658,4,9,3,12,4,6,10
Jayalalita,JOSH,Female,17-11-2007,jayalalita_josh@gmail.com,9d65013af0ae70b35e5373f876a05096,91-8939858592,7,4,6,10,3,3,6
Yuktha,Savitendra,Female,10-05-2010,savitendra_893@gmail.com,e5154961e551ff810ee7516956e1df2b,91-7789863213,6,22,29,51,5,3,8
Usha,R,Female,15-10-2004,usha_r@gmail.com,c0335fe88cb7d8a6220513556e718ee5,91-8849199687,74,9,6,15,9,5,14
Aishani,V,Female,29-04-2010,v_672@gmail.com,d9e1be087f9bcc8b540af4641fe988d4,91-7675787364,4,9,9,18,99,51,150
ZAIN-UL-ABIDEEN,H,Male,05-07-2009,h_564@gmail.com,deea609980257ec7a123a5968a940e30,NA,0,0,0,0,0,0,0
Chirayu,SAMET,Male,20-02-2004,chirayu@yahoo.in,146e9289efcaf183dd960ce7d1472b2f,91-7917324228,27,9,17,26,79,91,170
Raakhi,Q,Female,22-10-2008,q@gmail.com,b918107d6997a3b68f8356153242ef85,91-7115932968,5,9,6,15,6,3,9
Jayashree,A,Female,06-02-2005,jayashree@gmail.com,6c24f4853cfd62e43d7dbff463f2b5fc,91-9719328521,82,57,87,144,5,54,59
Krittika,E,Female,29-04-2008,krittika_e@gmail.com,1c95a326aba5c1a9c8fb76479f93b2a1,91-7713668524,4,9,3,12,22,58,80
CAISON,ALEXIS,Male,12-05-2008,alexis@gmail.com,1c45c13fc3c07390c92d1278018f9779,NA,0,0,0,0,0,0,0
Aparijita,ANSAR,Female,01-06-2009,aparijita_679@gmail.com,982ed1c737288984368161e44c184016,91-7736228789,69,1,99,100,4,6,10
Vaidehi,SHIVAN,Female,20-07-2010,vaidehi_shivan_453@gmail.com,e53d3cdcb169140de33b3cb36467b16a,91-8849214442,5,1,52,53,83,5,88
MOHANAD,M,Male,18-02-2007,mohanad_m_498@gmail.com,8682763ab8b62bd845538f608f84fcdc,91-9498689932,81,28,1,29,3,9,12
Ekadhana,Z,Female,11-03-2007,ekadhana_864@gmail.com,704c5f5e22102c4a261e10a851e2cd9a,NA,0,0,0,0,0,0,0
OLAWALE,MANSOUR,Male,27-04-2012,olawale_mansour_174@gmail.com,285fea90bf0c27c5e5a8bc5dd1eb9c84,91-9721117849,8,1,26,27,48,2,50
BIVON,LIONEL,Male,09-11-2010,bivon_lionel@yahoo.in,2f6de2c6efaa0142298862ea48410af7,91-7136421355,66,8,2,10,8,3,11
Mithi,L,Female,02-11-2014,mithi_l@gmail.com,7a088be98ff48c860a86cea5da647b3c,91-7626193186,15,56,16,72,8,37,45
AURON,VIBHAV,Male,21-06-2011,auron_vibhav@yahoo.in,8ef69424278190c2df9325506a29fd55,91-9277117474,66,5,5,10,8,73,81
WAHHAJ,AMIN,Male,19-08-2013,wahhaj_524@yahoo.in,f53f0b6bcf114b8a1baf0268a77acea1,91-8445269316,8,51,11,62,48,4,52
Sonia,Randhir,Female,29-11-2008,sonia_randhir_689@gmail.com,38bc8f203d50462bc9712cea304e2df0,91-7162835246,62,31,23,54,5,4,9
JIMMY-JOE,Kamraj,Male,15-02-2012,kamraj@yahoo.in,443b9c751aade9726b71d095931df91f,91-8266811479,2,63,8,71,58,24,82
JAYDN,O,Male,12-05-2011,jaydn_o_174@gmail.com,f1d3db7d2a9accbbfd3e46e639b278e5,NA,0,0,0,0,0,0,0
Naaz,E,Female,12-07-2008,e@gmail.com,91dec653b39224032b0e560e21169470,91-7968893552,54,45,5,50,3,53,56
NISHAN,M,Male,2005-0-21,nishan_m@yahoo.in,15ea9ca5325f9c4aff476c43f2cf92fe,91-9741824956,31,3,38,41,6,5,11
Kriti,Y,Female,21-02-2013,kriti@gmail.com,47201f9ce78957fc1bf62ab60b1579f3,91-8961537849,2,76,82,158,2,86,88
Neelanjana,L,Female,09-05-2011,neelanjana_l_145@gmail.com,6cc68e788f1559620bf77d2dcc21c172,91-8912576489,3,8,23,31,81,71,152
Mannan,PATRIK,Male,21-02-2007,mannan_patrik_613@gmail.com,86f453463a86a6c9de4476c9e2882264,91-8824545564,35,6,98,104,85,5,90
LAMAR,D,Male,13-01-2010,d@gmail.com,4abbf92f60287af95aa098dfa61580bc,91-8995495537,97,1,65,66,52,87,139
Chitrali,J,Female,03-09-2008,chitrali_j@gmail.com,75a78ff2c73239638c39f8079904eb7f,91-8696572126,87,6,8,14,5,49,54
Archan,ZIYAAD,Female,18-07-2010,archan_457@yahoo.in,f9200f449d949bf294b6dfa55172518e,91-7895437582,43,53,42,95,7,66,73
MEKHI,X,Male,19-01-2007,mekhi_x_783@gmail.com,7f53319a1596fafa0705046c92f71b50,91-9643743431,9,41,2,43,3,1,4
Nishad,S,Male,10-01-2008,s_176@yahoo.in,dc87b9ed0282c4f72359333c93384d57,91-9878699467,19,2,3,5,1,5,6
Navaneeta,CIARAN,Female,30-03-2011,navaneeta_678@gmail.com,28d977594f0f4e5ac6fb1d0030b58ee1,91-9755148132,8,2,3,5,5,29,34
Gopa,C,Female,12-04-2011,gopa_c@yahoo.in,426f602a445ed2674b317cef5539d1f8,91-7671828482,2,27,49,76,5,4,9
Ahilya,C,Female,14-03-2013,ahilya_c_346@gmail.com,c1a8f9829c3eff7e42c13ff616bbc610,91-7524687384,5,72,23,95,3,4,7
Paridhi,Devak,Female,2007-0-24,devak@gmail.com,a027f55be7410fdc40209d7177a75fda,91-7831396513,51,97,8,105,7,25,32
MILANO,W,Male,11-11-2007,milano_w@yahoo.in,1ff4016df93210720b246b132be8103c,91-9272728716,47,9,16,25,73,2,75
Amanath,B,Male,20-06-2012,b_581@gmail.com,7b76a9a201d809e844e8e8b5023bd240,91-9354471847,25,3,4,7,19,94,113
Hemang,X,Male,28-10-2011,hemang_x_493@gmail.com,a18af9847fe211a78826aa4a2dbd1845,91-9934292155,6,3,44,47,6,67,73
Nanak,Prakash,Male,05-09-2013,nanak_prakash@gmail.com,c1b982b2ababdf654b4ad57b4efb16d0,91-7382524361,27,33,2,35,89,17,106
Anya,P,Female,06-08-2009,anya@yahoo.in,cdaee0198bd6e3368f447f5328b4d5e2,91-7356424698,2,49,73,122,77,3,80
SHUAYB,J,Male,04-04-2010,shuayb_456@yahoo.in,c8351df3615e0f65a06c27660c9ce458,91-7141264863,3,63,47,110,8,3,11
Raksha,R,Female,27-11-2011,r@gmail.com,af6872919096964a6e2777c8cc0fdfd5,91-8432196595,3,5,58,63,8,7,15
Vimala,Dharmesh,Female,01-07-2004,vimala_dharmesh_368@gmail.com,d8c35627e77606297aeba408a7b58d14,91-7534119825,7,84,7,91,7,2,9
Ashavari,D,Female,05-03-2013,ashavari_d@gmail.com,0b0cb155424b11209e56679e6081e8d4,91-9969387355,5,29,93,122,36,4,40
RAJDEEP,H,Male,16-10-2009,rajdeep_h@gmail.com,bc67d32d205d23982783c0897bf30f28,91-8621881133,8,61,21,82,25,92,117
Damayanti,Ujagar,Female,24-04-2009,damayanti_ujagar@gmail.com,eae848c5870cdb1aaca1710b7a88211b,91-9978454532,9,81,76,157,54,6,60
Sundari,EFE,Female,08-06-2004,sundari@gmail.com,26627c205ea51fc943305292591005d0,91-7562682794,38,5,43,48,36,9,45
QUAID,H,Male,18-02-2008,quaid_h@gmail.com,e43c2d9103459fd9c30352f678f5fda6,NA,0,0,0,0,0,0,0
KAYLUM,TYMOTEUSZ,Male,13-04-2009,tymoteusz_896@gmail.com,d159b1378a3bcd38bbd49da8b1af1ec8,91-7821821431,41,3,5,8,2,2,4
Geeti,Shivshankar,Female,30-05-2004,geeti_shivshankar@yahoo.in,706329d2e222896c9145e348e4ea10e0,91-7844341947,4,5,1,6,1,2,3
Kokila,L,Female,24-06-2009,l_154@gmail.com,02e9c9cb347c67f13411e7565d413a6b,91-9474723288,99,85,6,91,8,58,66
CORBIN,AURON,Male,28-04-2011,corbin_auron@yahoo.in,c3b4f660d6dcbe5c23d380aa271d2a13,91-8519675728,41,44,2,46,8,1,9
DEMAR,MOEED,Male,04-08-2004,demar_945@gmail.com,821f945ce407d27f122f36877806903f,NA,0,0,0,0,0,0,0
Neeraja,Suhrit,Female,11-01-2012,neeraja_375@gmail.com,aca9f355f8b13c463eb3801b0ebf52f2,91-7484363698,3,83,8,91,52,34,86
Sumanta,Somansh,Male,24-11-2007,sumanta_somansh@gmail.com,a2eb8becf2458b569d5dc568c4f93c3d,91-7528283399,38,5,5,10,6,6,12
Anurati,B,Female,14-11-2013,anurati_b@gmail.com,571fc6c6c8bc82538166e68eacd86fc6,91-8282692242,53,67,46,113,13,1,14
ZUHAIB,YEHUDA,Male,14-02-2004,yehuda@gmail.com,bb3904b2ac39e753e907621b1ca47351,91-7584892973,9,3,88,91,28,1,29
JARYD,BEAU,Male,22-11-2013,jaryd_beau_234@gmail.com,5671ebab91b3724e11c18d8b4383b81c,91-7435517972,41,1,6,7,8,72,80
INDIE,CIARON,Male,28-01-2010,indie@gmail.com,72b07cf69cda095f3b7cc4cac983d2cf,91-7933211172,8,4,2,6,28,18,46
IBRAAHEEM,V,Male,29-09-2009,ibraaheem_v@gmail.com,e953e909b982d03629ca443d06f1d299,NA,0,0,0,0,0,0,0
Surabhi,TOMOS,Female,07-08-2009,tomos_493@gmail.com,6b3257641f5e6b9e255c1340b613bad7,NA,0,0,0,0,0,0,0
Smita,S,Female,02-01-2009,smita_386@gmail.com,19e6d87fb4d79236edc4f28573018e3a,91-8297712592,1,1,88,89,4,67,71
Daksha,V,Female,2004-0-3,daksha_v@gmail.com,89a4d1f87c0cd20f96e9e384d3dd2f90,91-8482317854,81,8,4,12,6,3,9
Indiya,YUSAF,Female,27-07-2004,indiya_yusaf_795@yahoo.in,383072888bfe47cd0ba1308c35739676,NA,0,0,0,0,0,0,0
Dayita,VALENTINE,Female,02-03-2010,dayita_valentine_496@yahoo.in,883a2501a07684389ab48cfb064e8e88,91-8376231931,83,49,2,51,69,6,75
Mangesh,RUSLAN,Male,06-08-2012,mangesh_ruslan_148@gmail.com,902049053f59cba1db1070b50247fc60,91-7943521442,66,1,8,9,76,65,141
Aditi,GOUTHAM,Female,20-01-2007,aditi_goutham_958@gmail.com,d7d160b218e0b6a9fd940622b40a00ee,91-9534943618,99,61,58,119,85,1,86
VISHAL,I,Male,14-06-2013,i@gmail.com,c2c8f68b2e534632376dcd3d909575ae,91-9557431544,63,52,82,134,6,62,68
Sudhith,J,Male,16-10-2011,j@gmail.com,47c7f7b8794824a1361a12f54fa30607,NA,0,0,0,0,0,0,0
SANTHOSH,ERAY,Male,26-07-2010,santhosh@gmail.com,41967cc295eac91e7b5303c10327d8cf,91-8514666533,3,69,1,70,6,99,105
Anasuya,JAHMARNI,Female,28-03-2008,anasuya_367@gmail.com,04326e3594eb04ed4faf76e12c3b372f,91-7325322274,75,1,3,4,58,6,64
Jaimathi,COSMIN,Female,18-10-2005,jaimathi_cosmin_836@yahoo.in,9494fe68f2e19342d054ce0132cfb7a4,91-7425287923,96,46,4,50,8,74,82
Nikhilesh,Nishith,Male,21-11-2014,nikhilesh_nishith_589@yahoo.in,2d52c7fbd12e354bf9dca86e9cd32415,NA,0,0,0,0,0,0,0
Pratigya,F,Female,20-07-2007,pratigya_463@yahoo.in,257ed495b19e22c9b2acab8e380e6481,91-9517492851,64,2,3,5,2,6,8
Parameshwar,K,Male,21-10-2008,parameshwar_k@gmail.com,43c394eee7869d4f1a7959a64a853979,91-9363654716,53,5,2,7,17,1,18
Kimaya,W,Female,10-07-2005,kimaya_w_519@gmail.com,bf2cda241ca79402ca597b253f3cf06e,91-9596442124,4,6,8,14,7,39,46
Jatin,T,Male,15-10-2006,jatin@yahoo.in,93fad8a9590b326a61bbb1c3e938d31b,91-7246685826,8,4,54,58,31,4,35
SAIKOU,G,Male,22-01-2010,g_527@gmail.com,47723d032725f41cfed141c7a1ac80a2,91-7465252718,39,36,61,97,16,5,21
KAMANI,Chinthanaichelvan,Male,05-01-2004,chinthanaichelvan_193@gmail.com,8fd8d7b8f854be67cec8f005a47c17a1,91-9925912371,9,93,1,94,18,3,21
Chhabi,NED,Female,19-01-2013,chhabi_ned_297@gmail.com,677fb2e1f5aacbe641cb0f2a504d8759,91-8445116422,39,2,1,3,96,6,102
MERON,MICHELE,Male,19-04-2010,meron_michele_739@gmail.com,d9a7fbbaadd38b75a8b269881d0f63af,91-7156985727,66,14,41,55,3,2,5
AASHIR,Devarsi,Male,08-05-2010,aashir_devarsi_982@gmail.com,f6eb48b8eac13714e0e46b05f43e7980,91-7715197773,4,1,78,79,57,3,60
Tarala,ZAHEER,Female,26-07-2013,tarala_zaheer_372@gmail.com,38e63675471f328e71788817015c98bd,91-7316769823,1,2,6,8,85,69,154
Sajili,S,Female,2004-0-19,sajili@yahoo.in,1d3b20f7c13f563d5d4bcbbab5845975,91-9724696365,4,9,54,63,45,91,136
Rijul,Sapan,Male,25-07-2007,rijul_948@gmail.com,8992c710bbc62195c58a4b12849c9a7a,NA,0,0,0,0,0,0,0
Gajra,Q,Female,22-11-2007,gajra@gmail.com,47870b5954b44f4abaaab246a7741b7a,91-7944113917,43,26,7,33,39,7,46
Manjusha,RAPHEL,Female,27-10-2006,raphel_123@gmail.com,9c553f306bd4280d4e9b6687d88892f3,91-7286243137,69,55,53,108,24,1,25
ELWYN,T,Male,20-05-2005,elwyn_t@gmail.com,6c2709745d4995083aaf9e0355a89fe1,91-7247921682,89,79,7,86,5,94,99
Nilima,E,Female,05-01-2013,e_289@gmail.com,719c34ab2b1f4ca616035f69604d00eb,91-8915195677,82,64,8,72,1,9,10
ANTON,Radhak,Male,19-08-2011,anton_389@gmail.com,773c92f127981b0f907049e185c13750,NA,0,0,0,0,0,0,0
Ellu,YUAN,Male,24-04-2007,yuan@gmail.com,7c31918e250007babfd81d272cf3b822,91-7158953636,2,47,5,52,8,99,107
JOSS,L,Male,22-03-2007,joss_l_957@gmail.com,797e42df252ab13aae46c795e86500b6,91-9843462528,5,6,1,7,97,8,105
ALED,FINNLAY,Male,2013-0-26,aled_finnlay_672@gmail.com,cb2eb88aaa2197887a9598b81c7cb0cc,91-7853689749,6,4,37,41,88,83,171
Pritikana,U,Female,29-06-2007,pritikana@yahoo.in,00702713ba11e18c625c01c10ba502a1,91-9855934524,7,86,63,149,95,89,184
MUHAMMAD-UZAIR,U,Male,14-08-2011,muhammad-uzair_u_641@gmail.com,5f925b911e486b3c42a1ff56f560f7c7,91-7947629216,58,7,73,80,6,54,60
Payal,V,Female,08-01-2006,v_867@yahoo.in,9a6af8cbad797f87f448c5c6456aa2c9,91-7671191614,1,8,1,9,4,2,6
Kesar,Shakyasinha,Female,28-05-2012,kesar_shakyasinha@gmail.com,8cfa20c29f68ea212f776fa842a97bc7,91-7466584358,9,19,49,68,74,2,76
Vallabh,P,Male,23-08-2014,vallabh@gmail.com,95096fc9fd17d27a731457625b86050d,91-9419685762,2,7,74,81,99,27,126
Urmi,J,Female,07-11-2013,urmi_814@gmail.com,6d5768096fa901f39cef4872c6ea0704,91-7711423812,4,65,57,122,6,27,33
Lipika,Samarth,Female,04-01-2009,lipika_samarth@gmail.com,c879d85f91da60a306b640bace649de6,91-9294695273,7,1,61,62,15,7,22
SUHAYB,V,Male,24-08-2006,suhayb_v@gmail.com,05134ff92515daacf5c0321960615eb7,91-8647669231,5,42,4,46,97,12,109
FRAZER,H,Male,23-08-2008,frazer_h@gmail.com,fee6ccd12b2cde005bf33715f304aa00,91-7353717538,76,2,6,8,73,91,164
AKASH,ILAI,Male,04-02-2013,akash_ilai_853@yahoo.in,c6aa7fe46b5481d7cea40b9bb739426c,91-7874943431,38,1,79,80,45,95,140
Kevalkumar,SAIF,Male,2007-6-31,kevalkumar_saif_341@gmail.com,e1fc4558af8e43457371c8c3f203d9a3,91-8679967489,29,63,2,65,29,5,34
Lavanya,TUDOR,Female,14-04-2005,lavanya@gmail.com,7d4154a3abff1aac764018a322b70b21,91-7758541347,26,96,1,97,4,8,12
Niramitra,AARONVEER,Male,08-06-2013,aaronveer_156@gmail.com,b6c74d8ba0d005ea774552013ba3733f,91-7356561482,1,8,7,15,9,6,15
Viveka,Bipin,Female,19-08-2006,viveka@gmail.com,0b09ef891578286ab263099b19b03b7b,91-7662991625,54,6,54,60,3,88,91
SAYYED,O,Male,16-11-2006,sayyed_538@gmail.com,5a48d4d720fbaa69a85585e38cf4b347,91-8827456131,3,1,8,9,3,13,16
Tvarika,L,Female,19-07-2010,tvarika_l_179@gmail.com,636726b40858f2542a7b677f2aab05f3,91-7692615721,9,99,2,101,4,2,6
Amitbikram,JOSHUAH,Male,10-09-2005,amitbikram_joshuah_467@gmail.com,c0687dc2357475aba299f7b854d75c09,91-8147988292,27,7,45,52,35,3,38
Tarannum,Z,Female,2012-0-23,tarannum_143@gmail.com,c8b7d9548db52fc0f2ba32d404eb3a48,91-9598126399,13,5,1,6,73,36,109
Minnoli,TOREN,Female,04-10-2006,minnoli@gmail.com,cb73ed6e5f0f2daee43b5441af57383d,91-7875342137,5,5,37,42,4,3,7
ZAKRIYA,Megh,Male,15-08-2008,zakriya_megh@gmail.com,e6170b9c1f8992ffe672353bd20243b5,91-9945561177,58,6,99,105,13,48,61
Bhojaraja,Chiranjeev,Male,14-03-2008,chiranjeev_673@gmail.com,4df77a398345ae95265ba2a06e7c8377,91-7798744113,1,9,5,14,82,63,145
ALISTAIR,L,Male,16-09-2013,alistair_469@yahoo.in,5f8e28bbfecf9f597680ee1ea086c84c,91-9595535617,49,27,3,30,94,3,97
MARSHALL,Z,Male,10-01-2011,marshall_z@gmail.com,b5a849b4436903929994ab11c8919230,91-7552219523,53,85,8,93,3,6,9
AKAI,YOAV,Male,21-01-2012,yoav_726@gmail.com,8cc81567ff0d72820107cb835c525fb0,91-8698629955,9,74,5,79,59,7,66
Sananda,Z,Female,13-02-2006,z@yahoo.in,1c9a579f9512b49483a62c98bf725dd7,91-7844319924,89,6,41,47,1,89,90
TATE,Z,Male,11-11-2012,tate_z_452@yahoo.in,66dce3db07a69fd794b6e5ea37c85f1c,91-7314422664,88,33,8,41,9,49,58
Upamanyu,MAHAMMED,Male,01-11-2006,mahammed@gmail.com,484ad133695fbbfc36aacdced0cea065,91-7961548963,7,4,9,13,38,3,41
Shyamali,L,Female,2008-0-10,l@gmail.com,b07eda6630a9fd37b4e08ca7f7a315fa,91-7647885172,7,6,8,14,9,58,67
ABID,T,Male,07-04-2009,t_517@gmail.com,c41d5c8d11dff68e430f37be5741936b,91-7137967564,8,7,33,40,5,65,70
Anisha,JOASH,Female,28-05-2005,anisha_joash_296@gmail.com,6fe98e9a2032a13d2c705943d634f0af,91-7619568478,8,32,55,87,6,4,10
Madira,Nigam,Female,19-11-2011,madira_nigam_267@gmail.com,d56ecd930b9e14e09b1c2c3feccbaf62,91-7481882939,6,3,27,30,54,9,63
Gandha,OLUWATOBI,Female,20-09-2013,gandha_oluwatobi_842@gmail.com,34260f30809ffa56dc7c27b06b0c31a9,91-7434789888,3,43,4,47,2,1,3
ADVIK,P,Male,2006-0-31,advik_p_941@gmail.com,24d312c27364502cabd3ecf191108601,NA,0,0,0,0,0,0,0
Prasata,Z,Male,05-11-2008,prasata@gmail.com,9aed1c8548d21f9ced20952b753be331,91-7789152787,5,16,5,21,8,73,81
Kanan,Shrikrishna,Female,10-06-2012,shrikrishna@gmail.com,31d666edb74e1e3b7f125460048458c5,91-9737875286,34,9,64,73,5,37,42
Manoritha,A,Female,27-08-2014,manoritha@gmail.com,1ee6e8261134d7745b36dc1806aad35d,91-8331532674,67,88,93,181,2,53,55
SAVIO,Z,Male,17-02-2011,z_172@yahoo.in,cf36eb63427b955e6494375463b869d0,91-7894663434,56,97,9,106,95,39,134
Rohitasva,Mulkraj,Male,10-03-2010,rohitasva_349@gmail.com,6622ec8c1e20eb7e3de082f581a24a5a,91-7982212444,65,4,7,11,13,34,47
Ahalya,DOMINIKS,Female,2006-0-6,ahalya_dominiks@yahoo.in,5340d34f57bae88edfd4a49767170821,91-7996697334,22,8,61,69,4,9,13
Ranjika,V,Female,16-05-2006,ranjika_v@gmail.com,c9d162928d618590d5ec30c61d872f72,NA,0,0,0,0,0,0,0
Viveka,NAITHAN,Female,21-11-2009,naithan_974@gmail.com,a6964f531c7733800fcffcc925a70f58,91-9481247217,4,5,32,37,3,62,65
ABDULKARIM,RAYAAN,Male,13-09-2013,abdulkarim_rayaan_178@gmail.com,129272cb9113d82fb55a293d9809cc7b,91-8464573689,1,63,2,65,3,8,11
Snehal,Z,Female,23-02-2009,snehal_z_617@yahoo.in,0af456f6ef9cf93c22c6c7aced3f0baf,91-8799182298,9,41,6,47,7,32,39
Tapani,P,Female,16-01-2011,tapani_p@gmail.com,602a7af396b7ea48d93e09d0a65d395e,91-9799886662,7,88,9,97,7,93,100
Aparajita,M,Female,19-03-2011,aparajita_m_962@gmail.com,2ab6f299ea6ecb1963d41468d1a735e5,91-7896126466,27,2,17,19,5,53,58
Nalini,S,Female,19-03-2014,nalini_s@yahoo.in,983b4318b3b647a1134d403493b56b57,91-7746151713,13,24,37,61,6,47,53
MILEY,LENNON,Male,13-04-2007,miley_lennon@gmail.com,03e481846f4fe45264b60d3134360573,91-9471344463,92,36,84,120,4,7,11
BROOK,P,Male,22-01-2006,p_365@yahoo.in,2390dd589b9974dd6fb39fb4b5a692da,91-7262328318,95,97,58,155,6,6,12
Samidha,Snehanshn,Female,01-07-2013,samidha_627@gmail.com,2d0ca9713113e2ce012a82dcbcdefd75,91-7585625819,12,26,7,33,5,52,57
Tapasi,ADETOLA,Female,2011-0-15,tapasi_adetola_528@yahoo.in,cd66b9f2862d0e5a3a6a3431cb5866f0,NA,0,0,0,0,0,0,0
Markandeya,C,Female,26-06-2009,c_312@gmail.com,c9d7a23054ca7446948491b1d1baab92,91-9631171459,3,24,5,29,9,14,23
Prem,K,Female,16-04-2009,prem_589@yahoo.in,984d3816e1b17c419446c47cbdd7d833,91-7836896191,9,89,9,98,34,52,86
LAWE,P,Male,27-09-2004,lawe_p@gmail.com,5acfe4c7154956494eee51c337e1a655,91-7663677677,4,1,8,9,9,21,30
LAYNE,Ajay,Male,01-02-2013,layne_196@gmail.com,56008e129524741ff35f564f513190c5,91-7123116372,8,1,51,52,11,2,13
Karunamayi,A,Female,03-07-2005,karunamayi_a_321@gmail.com,deb3d8e5a2f40bb67117963ed3090e8e,91-8525428447,6,99,86,185,9,1,10
Parnad,Chellapan,Male,16-04-2005,parnad@gmail.com,1ef7ea6830777c7edaf26fb413857ea4,91-8229665672,8,74,92,166,98,39,137
AMAN,Q,Male,24-10-2013,aman_q_673@yahoo.in,fe7e07d809ac184dccdcaa33d10d6a09,91-7995626182,21,26,3,29,2,1,3
Ibha,EDMOND,Female,08-06-2009,ibha_edmond_287@gmail.com,b0462ae6948e79ddafccfb93e3d19bdc,91-7611778346,66,73,8,81,8,9,17
Abhimand,I,Male,26-08-2012,abhimand_i@gmail.com,abdb66cdf8289ec69c61a54465e10f1a,91-8312989757,7,1,14,15,13,47,60
Pitambar,AJMAL,Male,17-01-2005,ajmal_718@gmail.com,24801874d47f39bfcabdbf431e1aef1b,NA,0,0,0,0,0,0,0
Sawini,P,Female,25-02-2013,sawini_p@gmail.com,809f2e9dcc90b3521c3e56d21892cd2e,91-7656385714,67,3,5,8,4,59,63
Rangana,S,Female,30-03-2007,s_635@gmail.com,a719a6d915ab49e171bc2e824acb8643,91-7577276346,1,31,67,98,1,27,28
MAREK,A,Male,01-04-2006,a@gmail.com,1c408f4fb611d81da65d6330dc1f541f,91-7648677652,4,8,34,42,15,1,16
MUHAMAD,RHYAN,Male,05-02-2009,rhyan_243@yahoo.in,6dbdeaff4f5ac4c6f8e0ee85a733d87e,91-8363274697,98,27,68,95,7,1,8
Pritha,Chandrashekhar,Female,02-02-2006,pritha_618@yahoo.in,c25ac0a5ed60af58816a2b677b39a492,91-8511369811,57,34,34,68,1,7,8
Gauhar,A,Female,14-09-2012,gauhar_a@gmail.com,1fc30ac0fc8f88f6beedd3bdd050c1eb,91-9424878342,96,12,53,65,8,9,17
MASON,TEJVEER,Male,19-02-2009,mason_tejveer@gmail.com,1b6f98ae742fa75e09f74ac8a8e08f04,91-7824689436,3,4,7,11,7,2,9
Kaumudi,Soham,Female,14-02-2009,kaumudi_soham@gmail.com,0ccf2de272cacd2be78b107e8aff55a7,91-9717524637,78,6,23,29,9,56,65
Hiranya,I,Female,27-09-2009,hiranya_i@gmail.com,0ce019b3da343258184b0e168541ff43,91-9172795226,41,6,9,15,26,28,54
Raka,ADEEB,Female,04-09-2006,raka_726@yahoo.in,3141d7f6b03839c5649f6082ead1cf7f,91-8977214193,7,64,47,111,16,48,64
Krupa,Z,Female,14-01-2005,krupa_z_317@yahoo.in,d0d14d89364d721ccbb4a50532446692,91-9176748973,33,6,7,13,2,7,9
HARLEY-JOE,M,Male,24-05-2007,m_812@gmail.com,2cf04e2ec9ad3551e6f4081133d5c506,NA,0,0,0,0,0,0,0
Pururava,Z,Male,28-02-2013,pururava_z@gmail.com,9c8d71324e92614cb30064e875f90099,91-9156742159,2,2,18,20,78,7,85
Daksha,R,Female,03-01-2010,daksha_r_143@gmail.com,2ce7b6e316e785e9a33abd25ea9922f3,91-8713355714,68,51,36,87,6,74,80
JAMARI,KIER,Male,30-10-2008,jamari_kier@yahoo.in,44ff589bdb62ff69c8477828f39c9dc8,91-7317293328,18,11,54,65,15,9,24
Shatrujit,K,Male,29-08-2006,shatrujit_k@gmail.com,f400b6596ce70a9b0e34753a1939e8e9,91-9782714351,6,62,29,91,28,53,81
Pragyaparamita,REMMI,Female,2012-0-2,pragyaparamita_remmi_698@gmail.com,70447c8f9297311f7e49816ff9846bb8,NA,0,0,0,0,0,0,0
Antara,ISRAR,Female,28-02-2005,antara_israr@gmail.com,c1ef3a67a36d1d822673268837a85c4c,91-9522791784,8,27,62,89,16,89,105
Maitra,JAHMAL,Female,28-11-2009,maitra_jahmal@gmail.com,1f2c442cdcb53b317349ce21d044bae6,91-8328133478,3,3,7,10,1,5,6
Indrasena,ANTONIN,Male,25-03-2007,indrasena_antonin_814@gmail.com,05cec8d15c40e7cb2c502bebea6e1c21,91-7691752996,51,1,36,37,6,8,14
Chameli,SEAN,Female,28-09-2009,chameli_sean@gmail.com,1350302d4269d28908ccd979692602e2,91-8659758682,87,9,95,104,3,4,7
Kunjana,SIYAR,Female,07-02-2008,siyar_825@gmail.com,1571434e3b59eec6d45aad0d61129f46,91-7298369851,13,15,71,86,82,27,109
Ambu,JAHEIM,Female,17-04-2012,ambu_654@gmail.com,881e8366ef0d305a8b7441322a5c130d,91-8499645982,32,7,78,85,59,31,90
Ishika,EBON,Female,03-07-2007,ishika_ebon_572@gmail.com,bc80697d626cd2b7e14b5de6eee7f505,91-7873642174,1,36,2,38,99,26,125
Bhavana,KIRILLS,Female,15-07-2006,bhavana_kirills@gmail.com,3e2553d800e14d0cee90b86a703c546b,NA,0,0,0,0,0,0,0
OSIRIS,HUMZA,Male,14-10-2013,osiris@gmail.com,01abcf2cc22ea7e76b4c631865155875,NA,0,0,0,0,0,0,0
Nabhitha,Mahith,Female,26-03-2010,nabhitha_478@yahoo.in,1f9baa7da17e0d582b9f1fa895fd6477,91-7484726863,7,34,6,40,4,71,75
MAXEN,A,Male,22-03-2011,maxen_a@yahoo.in,7994a9347f73fd376a1d7936d7655e78,91-7873126341,8,42,55,97,6,41,47
IESTYN,J,Male,08-01-2009,iestyn_j@gmail.com,8e0e366db21bcd2f0eea8e16bacf43e6,91-7138392146,88,9,38,47,58,52,110
ALEXI,P,Male,18-07-2007,alexi@yahoo.in,1520c266bd2938796785207177ec7368,NA,0,0,0,0,0,0,0
Panna,REZWAN,Female,24-04-2012,panna@gmail.com,0361b3058c6a35318ce44792b5cb1394,91-9933292171,9,7,7,14,1,8,9
Anurag,Abhishek,Male,2007-0-22,anurag_abhishek@yahoo.in,a7f0fa269b5e1c9b1ebcc7dfc0c5a814,91-7861383947,3,41,3,44,25,95,120
JONA,E,Male,26-11-2010,jona_e@yahoo.in,f41b9c067007621a5150d0e2de451667,91-8411555359,9,36,82,118,18,25,43
Ikshana,X,Female,19-03-2007,ikshana_x@yahoo.in,769fd6b2d06845fa183a8b3f3032b7fe,91-7199351235,2,36,5,41,99,6,105
Naveena,N,Female,04-05-2013,naveena_n@yahoo.in,0e3ceeac0871a0a5e5af77e6a5036a04,91-7628147383,3,6,4,10,8,14,22
Vaijayanti,H,Female,2007-0-9,h_539@gmail.com,870658c448af06e3f06070c040e5773c,91-7676734478,1,98,5,103,93,9,102
Prashanti,N,Female,22-02-2008,prashanti_n@yahoo.in,9d4b0ab259a35f33083b233a93bc160e,NA,0,0,0,0,0,0,0
Resham,HUNOR,Female,2005-0-16,resham_674@gmail.com,bfc26b937aa92f65995576130f8dc21f,91-7984485528,4,49,6,55,55,76,131
Bhuvanesh,KAMEEL,Male,18-08-2009,bhuvanesh@gmail.com,966a3fd4752f4e5daa294ca51756918b,91-7856482761,8,7,7,14,6,59,65
VIBHAV,N,Male,01-11-2013,n@gmail.com,89d3fa203654d5e2bc27ff219342f065,91-9799488764,97,24,68,92,99,3,102
Visala,DILLAN,Female,22-11-2012,visala_749@yahoo.in,96313ee0e5b032f595208a61c03479cf,91-8251135413,55,78,1,79,49,52,101
Sarasvati,C,Female,2012-0-29,c@gmail.com,c2777c994aa19550f075a6c9b48e8c02,91-8917374445,6,7,1,8,6,71,77
BRYNLEY,Brahmadutt,Male,11-05-2005,brynley@gmail.com,3778db1455ce79b58852d227b6150a81,91-8344134691,94,25,4,29,96,7,103
Poorvi,ZYON,Female,09-07-2008,poorvi@gmail.com,77755c5d0551cbf2d88f2f3d0cffa0a1,91-7818829595,4,6,69,75,1,6,7
Disha,Udyam,Female,28-01-2012,disha_udyam_459@gmail.com,f6c70f4d7413af32d189f94172a018a7,91-8322155542,3,3,3,6,47,7,54
Charumati,U,Female,03-09-2007,charumati_u_396@gmail.com,94d685632ad6e0dbe031dc2f2483a2f3,91-7939578277,5,65,3,68,16,4,20
Poonam,DREY,Female,12-02-2011,drey_598@gmail.com,1e035041e4935ed7ed9d39fd3dbb71aa,91-7131116472,74,12,34,46,6,65,71
Amitesh,R,Male,10-10-2009,amitesh_r@yahoo.in,05a378a7cb7f40fb646250cbbf4f43bb,91-7362873234,6,2,91,93,39,3,42
Dhuthi,Balgopal,Female,16-09-2012,dhuthi@gmail.com,3451305ec2ce6621a6eaf1feb42cdbb7,91-8786384786,8,59,76,135,8,28,36
Hiranmay,FRAZER,Male,10-09-2007,frazer@gmail.com,faeaf9f6b64285e0f40fdf67e6edec88,91-7597154743,4,66,5,71,13,4,17
Kurinji,KINLEY,Female,07-11-2009,kurinji_kinley@gmail.com,42a79d349ecdb7faa7e58f59e570868b,91-8898533524,6,44,13,57,8,9,17
RUEBAN,PIERCE,Male,27-02-2011,pierce_826@gmail.com,2bed7b2563575268b9c1e74c12c31eef,91-7537835612,4,2,3,5,16,19,35
Raghuvir,L,Male,29-05-2005,l_576@gmail.com,b4fa2b57c5aa60c62c87292d16ffa218,91-7521858985,6,66,7,73,23,3,26
CLAUDE,I,Male,11-05-2013,claude_936@gmail.com,fe9135e1d86bce15a24d493ea53d8070,91-7317487494,36,3,44,47,9,3,12
Jhilmil,R,Female,24-11-2011,jhilmil_r@gmail.com,327f92b357d6a905520ab233686002c5,91-7339178917,3,41,1,42,68,64,132
Anupama,D,Female,2008-0-20,anupama_d@gmail.com,a65fe8fa08d52f6580a9fd45af41805d,91-8393751656,45,6,77,83,8,7,15
Aadi,BLU,Male,06-10-2008,aadi_845@gmail.com,1aee866996a557c7eee3d31eed5a73de,91-8477532763,9,74,3,77,3,4,7
Kalindi,FLORIAN,Female,29-02-2012,florian@gmail.com,bfabd43b8fa4053377a9b057d4f400dc,91-7482468945,89,52,9,61,4,56,60
MEHTAB,O,Male,24-08-2005,mehtab_o_256@gmail.com,a45a6dea16b31f4ecff9cda13d3bf40d,91-9538986744,83,44,7,51,85,79,164
LYON,P,Male,26-10-2007,lyon@gmail.com,3cb6f7e6702f2fa3c6ed71526959a3aa,91-9625186178,67,69,45,114,2,75,77
FELIKS,H,Male,10-06-2011,feliks_h@yahoo.in,11e6b481409a54d574846b6a4f2d53a1,91-9535883682,35,26,41,67,5,8,13
Niral,Q,Female,03-02-2010,q_542@gmail.com,c33ea6086d4628aa938f79deeee9340e,91-9739222515,45,72,7,79,8,89,97
Chandalini,TARELL,Female,10-02-2012,chandalini_tarell@gmail.com,bde68916e975d49ff2d0fefa89156f7e,91-7317835166,75,1,5,6,83,8,91
LOURENCO,DANISH,Male,06-03-2008,lourenco_danish_129@gmail.com,e825ffeced9833d4f67f795f9a6bd920,91-7599564216,61,36,6,42,64,5,69
AARYN,P,Male,09-03-2008,aaryn_483@gmail.com,656fa1d1ecd94aa177dd94fee3eb6bfb,91-9385278117,52,4,1,5,46,8,54
Trishna,LIAM-JAMES,Female,26-06-2010,trishna_375@gmail.com,f5f6cd86bd311225dd5a55ef98d35ef6,91-7294655341,72,4,3,7,7,51,58
Jalanhili,Sugreev,Female,01-07-2010,jalanhili_sugreev_316@gmail.com,556596b2ec18cd63b8a5a1ecbcf68861,91-9737959855,1,25,7,32,2,57,59
KHUSH,N,Male,2009-0-7,khush_n_529@gmail.com,63dfd1580bd46b8a615946940a6c5bee,91-9679499127,72,3,47,50,6,72,78
Padmavati,KRISTIANS,Female,17-03-2005,padmavati_kristians@gmail.com,0afebe1f6b36a2527c7d2dac76b97547,91-7943736889,79,7,93,100,1,4,5
Mahalakshmi,X,Female,28-04-2012,x_189@gmail.com,5b60d6271b4269cf73026d8c3434b3ec,91-9313765415,56,4,32,36,76,4,80
Dayamayee,FRANCISCO,Female,06-07-2008,dayamayee_francisco@yahoo.in,83642bd5d037e3a791b79704af5d4022,91-7929582927,6,14,16,30,7,8,15
Geetika,Ulagappan,Female,2010-0-23,geetika_682@gmail.com,5d13d9a81990975a1283916120789c6e,91-8413266493,71,84,64,148,25,91,116
Hiya,LEV,Female,16-06-2011,hiya_lev_631@yahoo.in,9208f53ff49661a6bab7c8302a7298ef,91-7597784623,67,7,9,16,76,85,161
JACOBY,E,Male,06-03-2010,e@gmail.com,f4be891b17588e0d07f720135faace7b,NA,0,0,0,0,0,0,0
Shobha,S,Female,2008-0-7,s_172@gmail.com,5458989f04674b33c6fe541824a62fda,91-7835319658,9,18,5,23,78,9,87
Kasturi,O,Female,16-03-2010,o_678@gmail.com,59f2a29890df21bedd20323e18b8bf15,91-7471774528,62,94,8,102,96,28,124
Jagrati,KENLEY,Female,17-11-2004,jagrati_219@yahoo.in,453c40ee421985f990b5967ff28796c1,NA,0,0,0,0,0,0,0
Leena,O,Female,16-05-2008,o_925@yahoo.in,e73631b8ff994362cf29d965ee5daa70,91-8277636199,3,7,27,34,1,97,98
HARLI,H,Male,25-09-2013,h@gmail.com,fbf738d45ec31a59959e415d9ef9b261,91-8288991684,7,66,18,84,56,94,150
CAELAB,U,Male,21-06-2013,caelab_349@gmail.com,f34e3bc345531565bfa81d9a4e3ac843,91-9714346971,58,8,4,12,55,44,99
Agastior Agastya ,E,Male,03-09-2010,agastior agastya _e@gmail.com,19251d10f50813a798af5b2d0ccac230,NA,0,0,0,0,0,0,0
KIER,Balram,Male,2004-0-31,kier_balram_874@yahoo.in,f736048115ddce57b03771089d4047a6,91-7323528561,7,2,6,8,6,49,55
LYLE,U,Male,18-11-2006,lyle_u_748@gmail.com,32c40599cd6a393855a985ba0b4f4290,91-8553116854,5,78,6,84,25,5,30
RICHARD,AMBROSE,Male,24-05-2006,richard_ambrose_289@gmail.com,319096625ffb124d591179582aeafe1a,91-8915337133,5,32,3,35,35,12,47
KIYAAN,O,Male,08-01-2007,kiyaan_o_384@gmail.com,8da6361187f29a3b54f5fe2c61a788dd,91-8881245267,75,99,95,194,79,3,82
HARVIN,TAIGAN,Male,08-10-2008,taigan@gmail.com,f09b59d388d44da0cf3ba68d81afca67,91-9259346899,72,6,57,63,16,2,18
Mahubala,RALFS,Female,02-06-2009,mahubala_ralfs_389@gmail.com,f3ab20f4b1de08f2d389d0fed170cf75,91-8949192994,5,29,91,120,5,4,9
Ujagar,FINDLAY,Male,19-02-2006,ujagar_findlay_281@yahoo.in,13785671051e4ea869c7614e2a8427e8,91-7462256697,77,1,2,3,2,87,89
KORNEL,Prasham,Male,2005-0-15,prasham@yahoo.in,9e46736e03fb891f88e50212fa10bd1a,91-7178857974,7,8,7,15,7,38,45
Shyamasri,GWERN,Female,02-01-2005,shyamasri@gmail.com,4a73a1abfdb445051c788558a6b6eb4b,91-7331247334,39,66,6,72,45,9,54
CHUKWUMA,B,Male,26-07-2010,b@gmail.com,1eb65840b09c9c30674e1fc5b65bc883,91-7677224772,1,9,35,44,7,84,91
YITZCHAK,P,Male,08-05-2013,p@yahoo.in,3c976370843b1677fb3ec8b10025a356,91-7887482334,6,42,58,100,35,33,68
CALLEN,Hashmat,Male,30-03-2006,hashmat@gmail.com,85473a12101181614251ab2e26c18a20,91-7745667349,96,2,12,14,15,2,17
Kusumlata,B,Female,06-02-2009,b@gmail.com,34bef8fed0f13b919a05ece57376a415,91-7861427829,8,3,6,9,4,7,11
UZAIR,Q,Male,2012-0-13,uzair_q_647@gmail.com,46162a1b8f2b5dc1424815e9606dd715,NA,0,0,0,0,0,0,0
Indukala,G,Female,12-03-2011,indukala_g_586@gmail.com,1aaa0ae27b6dbd1aa60e961dd479162a,NA,0,0,0,0,0,0,0
Vinodaor Vinodini,Rajanya,Female,21-06-2008,vinodaor vinodini@gmail.com,363c3d2925e89fec64932a3c595775bb,91-7191619538,78,42,1,43,61,95,156
Niral,Y,Male,16-04-2011,niral@gmail.com,81f1e1bd53313203e29868f3bedc8c3f,91-8637194511,46,5,2,7,9,61,70
Kanika,PHILIP,Female,23-02-2011,kanika_372@gmail.com,8d3496836446950cc02cb4f85e5e1b03,91-7475513758,6,44,2,46,47,3,50
Rajeshwari,W,Female,11-11-2011,rajeshwari_581@yahoo.in,dc135ed77344063471b1e7a6c6184a37,91-8726814389,2,84,88,172,35,17,52
Manav,Sohan,Male,23-09-2005,sohan_381@gmail.com,9468989a0589c0bde8805761ab360c5c,91-7194893672,2,5,7,12,5,23,28
EDDISON,Akash,Male,22-09-2012,eddison@gmail.com,204c1fde37ccdbe9913ef3bd4df11f06,NA,0,0,0,0,0,0,0
Vallari,T,Female,25-02-2010,vallari_t_784@gmail.com,a1d3ee125eb40f7eb2c0daa79003ca4b,91-8964374693,18,3,2,5,94,94,188
EVAN,D,Male,10-02-2006,evan_d@gmail.com,c9797618d1c95741fbcb6c984de5d756,91-9459158871,9,3,9,12,36,5,41
Gulab,C,Female,27-07-2006,gulab_c@yahoo.in,be7389add98f3f3a10acab00ee01bae8,91-7946176565,13,15,8,23,18,16,34
Jyotsna,EDUARD,Female,23-11-2009,jyotsna_eduard_874@yahoo.in,a1d411ebce8e3a2378bd2c04b8c459ab,91-8687615659,52,65,62,127,2,4,6
Anasuya,N,Female,24-07-2006,anasuya_148@gmail.com,c8a09b0ea42456032c6aabbfd4232347,91-9834752975,3,98,2,100,48,3,51
Shailesh,Gurudas,Male,01-11-2005,shailesh_gurudas_297@gmail.com,08f402a851e1264ff1c5afd0248fb68e,91-7745775738,1,8,6,14,32,3,35
Rasna,Oviyan,Female,22-02-2009,rasna@gmail.com,832cd509f44afe044aa65dc3b213e447,91-7917945469,5,1,1,2,57,9,66
MAHD,T,Male,01-02-2008,mahd_t@gmail.com,3828fccc3ee8317adb82a84096dd408a,91-7241483444,9,65,51,116,85,3,88
Chanda,X,Female,16-06-2009,chanda@gmail.com,ee6cbc2afa808552d2c341f1449b9b4a,91-7894692611,1,11,92,103,82,1,83
Aalap,C,Male,14-07-2007,c@gmail.com,11afcd3d9a8fc944589c3b2888ef121d,91-9449541868,4,64,45,109,72,66,138
Ujas,DEANO,Female,07-08-2010,ujas_deano@gmail.com,051915e86656cda6b791a13ad89f0912,91-7139814398,6,88,14,102,77,9,86
Shashi,Y,Female,12-06-2005,shashi_y@gmail.com,97bafa310dbece404c3e972c58285baa,91-7196958976,6,53,4,57,3,2,5
LEE-JUNIOR,W,Male,03-04-2007,lee-junior_w_683@gmail.com,42f65a30df19db258a2a768dd6de7ca0,91-7748348538,54,4,58,62,4,4,8
Damayanti,L,Female,14-04-2009,damayanti_463@yahoo.in,588375f5136573a9013476cb1399b301,91-7362343586,96,66,2,68,1,29,30
BASIT,Z,Male,24-05-2006,z_984@yahoo.in,f5d2ecf1da5b8148be1235f22509e0d8,NA,0,0,0,0,0,0,0
Durvaor Durba,F,Female,28-09-2009,durvaor durba@gmail.com,7bb9532f641e7db919474cee30712436,91-8953426272,9,7,32,39,23,55,78
Mukta,NARYAN,Female,02-03-2008,mukta@gmail.com,ceec7dd534bd7bfb7e863aa335503031,91-7777982918,24,6,5,11,63,35,98
MYLIE,K,Male,25-06-2007,mylie_k_613@gmail.com,2b69f575c36599e41f7b28db42ef768d,91-7136778499,79,52,68,120,5,3,8
Ekantha,P,Female,16-10-2004,p_896@gmail.com,9b760c55dc144d5a56428781c79dc13e,91-8737673886,7,9,59,68,1,8,9
Devina,M,Female,2008-0-4,devina_m_485@gmail.com,7799776b82a599e54b7db96b9d716685,91-8545144246,5,87,5,92,8,48,56
Shadab,JEZIAH,Male,2009-0-25,shadab_835@gmail.com,0dd0cf9f12780a8f744d09194920c4cb,91-7181278917,48,2,9,11,73,61,134
Samiran,V,Male,24-08-2008,samiran_v@yahoo.in,5e2f31cb8ec64da65d8d29796c179632,91-8293962811,6,3,5,8,47,6,53
Charitra,RISHI,Female,08-11-2004,charitra@gmail.com,12cfc65021cfc6af2f3a9ba143d48ba7,91-8769746418,53,28,4,32,3,16,19
Apala,S,Female,15-01-2010,s_529@gmail.com,b876fef24a1d2d7c51305d58515c7ffc,91-8639533291,6,16,66,82,9,5,14
Swetha,KASH,Female,23-02-2011,swetha@yahoo.in,c7aa7e80dfd90a51df05eeb021e3f02f,91-7843683874,6,3,73,76,4,32,36
Khyati,I,Female,25-11-2013,khyati_735@gmail.com,ec22c48b8f50099dce7eb72ff45fb42e,91-8427266573,16,85,1,86,56,69,125
TYGER,Neelmadhav,Male,21-10-2008,tyger_531@gmail.com,e8fe4101a70f45684870aad8932d0c3a,91-7882325474,89,1,8,9,5,91,96
KONSTANTY,Tahir,Male,18-03-2006,konstanty_tahir@yahoo.in,af48e91b07d451ef7a41a83e28e0dd9d,NA,0,0,0,0,0,0,0
Padmaroopa,TAYAB,Female,15-07-2007,padmaroopa_tayab@gmail.com,4292160d1657baa31e2949a4d9c852b5,91-7877736461,41,26,3,29,99,79,178
Parvati,O,Female,26-11-2013,parvati_o_684@yahoo.in,5a5b0f188178dafc707e6b4083a7962c,91-7269227785,53,1,39,40,6,77,83
Manikuntala,AIDEN,Female,02-05-2008,aiden_398@gmail.com,5d7b4b1464be78686ecac9c7b36ef9cb,91-7246813131,48,97,25,122,2,76,78
Hemakshi,C,Female,11-08-2014,hemakshi@gmail.com,2a38c338b6a5e3cc4bb8021d57cb146b,91-7544445185,92,3,9,12,5,41,46
SHARIF,P,Male,26-06-2009,sharif_p@yahoo.in,44cf47b7b67e9bdb9dba4d7448e52781,91-7872463366,13,19,99,118,51,41,92
NATAS,O,Male,15-06-2007,natas_o@yahoo.in,c28f0311daea800faf6ec0ecf2f3772e,91-9341383214,43,43,5,48,87,67,154
Soma,Q,Female,30-05-2011,soma_q_576@gmail.com,d0f3e0f91c711c8f9e4bd28e69e267ad,91-7756918788,2,84,21,105,5,9,14
Disha,Fahad,Female,26-09-2008,disha_fahad_152@gmail.com,893eb40a649877ef59b9e466a03b5dc1,NA,0,0,0,0,0,0,0
Chhabi,W,Female,10-08-2011,w@gmail.com,6976112c2bf66acd56ffc3b70c3a50b6,91-7558386688,93,7,8,15,63,93,156
PAWEL,Vatsal,Male,04-01-2008,pawel_468@yahoo.in,9fc86d3ad503ffc9917949af43717152,91-9537763668,7,9,1,10,7,65,72
Sumana,M,Female,23-07-2005,sumana_m_294@gmail.com,668b538b746b59dc5012388473749066,91-7554489262,73,29,37,66,29,6,35
Manuj,W,Male,06-05-2013,manuj_915@gmail.com,c1cbc49813cdd3f25e300b7bd92a00f3,91-7884788659,8,47,27,74,9,39,48
Suhasini,IKRAAM,Female,23-10-2011,ikraam@gmail.com,6cdb96338718c6e48ae948731cc3d38e,91-9195149476,22,44,47,91,15,59,74
Mrigankamouli,MAAZ,Male,09-10-2007,mrigankamouli_maaz_671@yahoo.in,238b69c6d995206b3a2013236dfe3ebb,NA,0,0,0,0,0,0,0
Pragyawati,E,Female,09-10-2008,pragyawati_954@gmail.com,4f0e5c96824cfe5738aaf81cc447969c,91-8197757859,37,4,1,5,5,8,13
Mahubala,M,Female,20-11-2005,m_167@gmail.com,33a3f3776b0833f9e8be5d7c3da629e5,91-7445673529,38,2,49,51,49,9,58
Ina,ABDUR-RAHMAN,Female,17-06-2009,ina_abdur-rahman_497@gmail.com,1f8b4bbb862a153cfa2545caafa8484f,91-7739125136,14,42,83,125,79,35,114
Punthali,O,Female,04-03-2005,punthali_o_735@gmail.com,7933d670f029e1c54cc3ce4492f5f37a,91-8368788391,9,41,8,49,42,1,43
RAJA,J,Male,05-06-2012,raja_j_921@gmail.com,2269ab0337fda8d490d05a1deccaebe5,91-8196952636,42,84,18,102,93,1,94
KUDAKWASHE,Nityasundar,Male,26-04-2005,kudakwashe_nityasundar@gmail.com,d22ad3c070ac17ac20c35f9bb3641241,91-8861571478,7,3,7,10,9,9,18
Mudrika,RAOUL,Female,12-06-2007,mudrika@gmail.com,ef17775afbed578f9c45f9de983c6f79,NA,0,0,0,0,0,0,0
Nandi,ABDELRAHMAN,Male,29-10-2008,abdelrahman_358@gmail.com,6f6e29c352c8d8529238d9a402519709,91-7944524494,4,45,8,53,3,62,65
FILIP,VUONG,Male,21-11-2010,filip@gmail.com,be631bffadecad536e7b80175fdc1db5,91-8275532157,34,6,3,9,2,4,6
Triyama,L,Female,24-07-2005,triyama_l@gmail.com,61597f4e0f5b4ce4d9c1f5ab0a536480,91-7148173114,3,1,39,40,93,4,97
GUILHERME,Shriyans,Male,29-10-2008,guilherme_shriyans@gmail.com,0eab5e7345ece5622154ca5116232a6a,91-8425888565,59,7,21,28,21,2,23
Pia,Satyapriya,Female,26-05-2007,pia_satyapriya_925@yahoo.in,65cd7cb591773155155d18a86061d1b4,91-7828986935,4,5,59,64,68,66,134
Nachni,WOJTEK,Female,20-09-2005,nachni_wojtek@gmail.com,f3a4e0b05ba106630f08b2db45477b0d,91-9331415264,91,43,34,77,6,3,9
JAMIL,W,Male,17-02-2007,jamil_w_924@gmail.com,f6479cd723230a609a289a76aa4418e4,91-7123185656,4,52,5,57,2,3,5
Hanumant,Keyur,Male,24-02-2004,hanumant_keyur@yahoo.in,22149edebc06d40ebb45593b2138498a,NA,0,0,0,0,0,0,0
LAYTON,N,Male,29-10-2006,layton_n_351@gmail.com,b3f8a1e3cf07e6298cb78ec6cc8a1ccb,91-7625845244,12,77,45,122,8,8,16
Aksithi,Kausar,Female,21-08-2013,aksithi@gmail.com,943fd5bbd82fe8fe75d5969991f6b7cf,91-7335896587,87,7,7,14,45,3,48
Shrilata,Nandi,Female,14-06-2012,shrilata_nandi@yahoo.in,60b78c613779f45a147e526039d945ee,91-9232797829,38,89,82,171,78,18,96
Madhumati,OLLIE,Female,12-08-2008,ollie@gmail.com,7a4cd325840d9b98c1e545b3ccbbe290,91-7329462643,4,32,7,39,5,3,8
Mithra,I,Female,29-11-2005,mithra_542@yahoo.in,c09beeb56819bdee6c8a22bd745920bc,91-8938923599,3,95,5,100,2,3,5
Savarna,B,Female,23-08-2009,savarna_b_648@gmail.com,4849e3d7ba9d680d7a515efef24fee93,91-7547868832,1,4,46,50,85,1,86
JOBAN,X,Male,16-03-2006,x@gmail.com,46207decc970191535237c48918353bc,91-7635212579,67,7,38,45,89,19,108
Suhina,FERDINAND,Female,07-11-2010,suhina_642@gmail.com,07414c181d643bb64c933eae783b7e2e,91-8941788313,8,47,45,92,2,66,68
Raghunandan,Someshwar,Male,25-03-2011,raghunandan@yahoo.in,f6d8156484ef5132dace7b338039acac,91-8447564747,4,94,2,96,1,2,3
BENYAMEEN,N,Male,2012-0-22,n@yahoo.in,0b21b9c37992c20db323cad70cf4efd8,NA,0,0,0,0,0,0,0
DAWIT,ZACCHAEUS,Male,25-06-2013,dawit@gmail.com,5f4e1341b4865f571c814edfc9974663,91-8395571686,38,88,6,94,2,4,6
Naganika,A,Female,12-10-2006,a@yahoo.in,5b9415a693350294b7ce52eaa8556b1c,NA,0,0,0,0,0,0,0
Mahagauri,KACPER,Female,02-11-2005,kacper_541@yahoo.in,0c98438731ba7e6e13cea9e5ee506e57,91-7486286949,5,9,8,17,7,9,16
Navaneeta,UCHENNA,Female,12-10-2010,uchenna@gmail.com,c00b81c0876fe023037b0c072552c196,91-7393599953,6,37,7,44,3,8,11
DANYAAL,AIDEN-JAMES,Male,26-07-2011,danyaal_aiden-james@yahoo.in,b291c835a8c8c83ce0fe7d42403f658c,91-8351849544,9,19,3,22,35,27,62
Vagdevi,DWAYNE,Female,25-11-2013,dwayne_123@gmail.com,28a8b0d999616a74764309b702966957,91-7527572566,34,53,5,58,1,45,46
HACI,KYA,Male,09-04-2005,haci@gmail.com,c10058b7fd750f4a14d8300ad907fe61,91-8456771681,54,6,7,13,33,39,72
Keshika,DHANYAL,Female,24-09-2007,keshika_dhanyal@gmail.com,41175e07e8decf67dda7ba68304be4de,91-7228738738,4,25,18,43,54,92,146
Dharmachandra,R,Male,2007-0-14,dharmachandra_r_534@gmail.com,c319e85186b1e784f3efa730e50b1f2f,91-7819437293,2,2,9,11,39,2,41
YOUNIS,RAYDEN,Male,15-01-2008,rayden_514@yahoo.in,c6f4b7abb1d3bde2db6c9fbf471d0192,91-7664425114,5,7,75,82,78,1,79
JERIMIAH,ANDREI,Male,26-09-2006,jerimiah_andrei@gmail.com,b776c4a3b39c8297c32a5ad791ba06cf,91-8828641922,21,7,49,56,2,58,60
Anandaor Anand ,U,Male,20-11-2007,anandaor anand _u@gmail.com,a3dd88d415020f131787ab4bce24aa51,91-8176364672,4,14,7,21,96,9,105
GUTO,Sutejas,Male,20-06-2012,guto_sutejas_126@yahoo.in,28c11b288520aa10355a405e3ed9c6f8,91-9476453797,9,6,3,9,2,57,59
Sadhri,ABDIRAHIM,Female,15-04-2012,sadhri_abdirahim_739@gmail.com,b4139ac3e7a196305ab908cea50ae56c,91-7842778217,4,9,4,13,62,3,65
Dayita,I,Female,03-08-2006,dayita@gmail.com,590192e682e0bd57d7d63f018d93a2db,91-7392212678,4,1,33,34,12,29,41
Jaspal,A,Male,27-07-2010,jaspal@yahoo.in,b2403011abd4bba9537ce7358638b8c6,91-9639637692,11,5,4,9,82,21,103
KORNELIUSZ,AZIZ,Male,28-11-2008,korneliusz_aziz@gmail.com,6731dc1a79d8942a3502a62d7fc5bb4b,91-7591433244,89,31,82,113,23,15,38
Upama,V,Female,08-10-2011,upama_v_261@yahoo.in,4468261c48313626af2e7b8a677af19d,91-8147311984,64,46,5,51,76,17,93
Amulya,ROSSI,Female,09-06-2005,rossi@gmail.com,47b78e438f8f8aa0f98133b16b2e7dc9,91-7788494933,76,7,6,13,16,14,30
DECON,MARVIN,Male,09-02-2005,decon_marvin_659@gmail.com,6be1042be40d7f5b3415af4b9a22b020,91-7298518718,17,97,1,98,6,15,21
MOHAMMAD,B,Male,11-07-2009,mohammad_b_289@gmail.com,04658f7ead3329c088c3e19d69d6c94b,91-7139882174,46,7,17,24,86,4,90
Vipula,Sugriva,Female,21-05-2013,sugriva@gmail.com,a53a7fe5eecee7d3e25f6515a8dcb52e,91-7951242541,3,9,4,13,67,2,69
Sujash,RYLEE-JAY,Male,08-06-2012,sujash@gmail.com,d368e50fcbed0a60bed699b685fb100c,91-9938963839,4,92,8,100,5,65,70
Sucharita,T,Female,23-07-2005,sucharita@gmail.com,bc26686b3e20d9a50d4ba3a72ea8c43b,91-8164645528,55,4,61,65,7,84,91
Abhiprithi,ELIO,Female,21-02-2010,elio@gmail.com,4e874df506882fac07ec43b4f9cf556d,91-7238657494,4,48,52,100,63,6,69
LUAN,J,Male,19-09-2010,j_241@gmail.com,34d790e80d470aa787194cf020e84b53,91-8883441793,49,8,72,80,51,14,65
Parnal,EDWARD,Female,14-09-2009,parnal@gmail.com,869c859713c4d7d7e096901769f90511,91-8451357126,34,98,46,144,2,9,11
Devak,JOHNPAUL,Female,06-01-2007,devak_431@gmail.com,a22caa7b84b13c23ebf665e29e684d36,91-7751675262,31,87,85,172,16,8,24
Gurpreet,TWM,Male,20-10-2006,gurpreet_twm@gmail.com,3069f007e270c8a3397aa8c728323a53,NA,0,0,0,0,0,0,0
Menitha,D,Female,18-09-2011,menitha_d@gmail.com,01eb09e03061910e4876be5c7aa20bb3,91-8431218568,16,6,8,14,63,38,101
Suchandra,Y,Female,16-11-2006,y@gmail.com,10882d669ca6b739a0979e6f4f394992,91-9512377228,64,7,4,11,1,95,96
Sarama,E,Female,10-11-2011,e@gmail.com,1458b051247a8cf2a3d16c0d3857200e,91-7366835321,78,1,9,10,2,6,8
JABIR,W,Male,21-05-2010,jabir_w_932@gmail.com,5468735cf8f1cb5aa238220a108113a7,91-8325922141,82,8,9,17,8,42,50
Nishtha,MU'ADH,Female,26-11-2009,nishtha_mu'adh@yahoo.in,ee30b2f310a7df754046592fe66f5465,91-7955112692,8,8,98,106,1,5,6
KIARAN,T,Male,10-03-2006,kiaran_t@gmail.com,5f3936088a03243b53a0fcb9dcf48cbe,91-8482458571,17,1,6,7,79,39,118
ROWAN,R,Male,20-02-2013,rowan@yahoo.in,b7846e319d782ca750ddc49a15ff6ec9,91-7716556782,18,71,81,152,98,85,183
Anokhi,A,Female,20-04-2011,anokhi@gmail.com,56ac8220d9917d67e3ba056423f77d2f,91-7663822613,6,4,2,6,9,11,20
SZYMON,H,Male,01-03-2007,szymon_h@gmail.com,56bf709cb6e61520a20e3f967c62f860,91-7277723739,14,8,19,27,45,4,49
DEE-JAY,Y,Male,28-08-2007,dee-jay_y_125@gmail.com,164524d9cf9affed95cf858b366dcda6,91-7849931763,62,5,4,9,38,3,41
Jasoda,CHE,Female,24-01-2012,che_842@gmail.com,017f90999da21aec3d516e6b872fdd6d,91-7572679489,3,73,54,127,29,7,36
OLUWADAMISI,F,Male,28-04-2009,f_217@gmail.com,e4405c48b1e1cb34a259e35c2acae14a,91-7371895215,81,45,64,109,61,24,85
Asvika,U,Female,07-05-2014,asvika_u@yahoo.in,4252e9af50a9a0c216e163058899c5f8,91-9667247883,1,2,75,77,3,85,88
Shyamalima,N,Female,30-03-2010,shyamalima_n@gmail.com,c4187faa9a786d5c72dbd7e3a773427b,91-7197853618,91,5,4,9,24,56,80
Sragvibhushan,T,Male,07-03-2013,sragvibhushan_t_926@gmail.com,b31a5a5bb595efa15b5597f9e98f9eee,91-8985181928,2,13,8,21,97,62,159
EDUARDO,MANRAAJ,Male,21-05-2006,eduardo_manraaj@gmail.com,d6f4a4b6048f3b07ce7d3be78c9d3be0,91-8194924325,4,11,8,19,1,53,54
Devalatha,N,Female,15-04-2012,devalatha_n@yahoo.in,13d442fa629b4d27453b100d04f31f92,91-7664867549,64,56,5,61,2,34,36
SAMAY,HURAIRAH,Male,23-01-2013,samay_hurairah_123@gmail.com,c7a2e258fafc390d43a48da68368d910,91-9548878965,6,52,64,116,2,55,57
SOLOMON,G,Male,28-08-2012,solomon_g_938@gmail.com,c5320d44738cb87dac5446fa2fdf2f2a,91-8754492196,74,38,4,42,5,46,51
Urshita,G,Female,26-07-2010,urshita_g@gmail.com,e146daf893afbd7ccdbe9995512b0b7e,NA,0,0,0,0,0,0,0
Ujjanini,K,Female,2011-0-27,ujjanini_k@gmail.com,6672eaab95afefb416182044efc591c0,91-7344655973,87,81,4,85,1,97,98
RAVINDER,YAKOV,Male,02-01-2009,ravinder_yakov@gmail.com,cc56a506de25b1e8548648ff912a9faf,91-7793662447,1,2,23,25,42,1,43
Sudarshana,TANAKA,Female,06-11-2009,sudarshana_598@gmail.com,62edac42f5dab9c3780304151c1372c2,91-7349225295,74,24,2,26,4,79,83
Nihal,O,Male,21-09-2012,nihal_o_824@gmail.com,ff6a75d0854245357ebf8e9600860d91,91-9178367866,9,35,47,82,66,78,144
Jyotika,U,Female,08-01-2006,jyotika_u_834@yahoo.in,a26f01a4fef49eace846105808853fdc,91-8428794649,75,77,9,86,5,1,6
Amari,S,Female,13-05-2005,amari_s@gmail.com,5d9f6fd54ff9d7161fe76555d0b8da6b,91-9715317621,87,8,9,17,7,29,36
CLIFFORD,S,Male,09-02-2004,clifford_s@gmail.com,655d45cbbc3850445817ec71367481f7,91-9943143954,8,46,5,51,25,5,30
Triyama,HAREEM,Female,22-07-2009,triyama@gmail.com,f4fcf9d9c2d601e191507612062c62ec,91-7285454313,49,7,39,46,72,73,145
SAQIB,D,Male,22-05-2008,saqib_d_526@gmail.com,977e4e3e6c1c44f9a597c98a4bfdc0a7,91-9623272462,42,5,8,13,1,8,9
Vanita,T,Female,28-04-2012,t_687@gmail.com,35cb6247ad9de64336f6f747a9a2f9d5,NA,0,0,0,0,0,0,0
Shrilekha,M,Female,08-05-2012,m_783@yahoo.in,1dcdb008650b6560dd842d76e7a24075,91-8174333582,2,85,45,130,96,7,103
Ganapati,ZIXUAN,Male,19-01-2010,zixuan_738@gmail.com,50e29bc786393da5e14b071cd4c1fd18,91-7762461759,8,3,7,10,86,8,94
Karuna,Q,Female,21-06-2007,karuna_319@gmail.com,9c08a811d79e9b85b846c0e384101737,91-8716117429,5,4,81,85,25,3,28
Anamika,L,Female,11-05-2013,anamika_l@gmail.com,0c5360cb4099fc500a9662f211d12b71,91-9755351551,53,33,43,76,2,5,7
Ananya,YEHUDA,Female,19-01-2010,yehuda_986@yahoo.in,6386c67bffef29794258f13d36af5996,91-7515632581,1,22,34,56,1,8,9
Tarannum,KELLEN,Female,26-06-2007,kellen@gmail.com,6c28920b4d5a25d5662cdad1b7d986f6,91-9394864632,59,3,92,95,3,23,26
Kalanidhi,V,Female,12-09-2014,kalanidhi_v@gmail.com,bfd0156cf9cf38664f5ebdb69fce3c7f,91-7991246355,1,66,7,73,85,3,88
KAIAN,O,Male,01-01-2013,kaian@yahoo.in,f727790f8d8f361964f8e60aeb5e3a47,91-7888792969,62,5,2,7,3,7,10
Dhanashri,L,Female,05-06-2014,dhanashri_l_469@gmail.com,96a965413c9680e48677f7b2cdbc5db0,NA,0,0,0,0,0,0,0
Lokranjan,Sumitra,Male,2013-6-31,sumitra@gmail.com,2804c2dd3bf559d821105be3dace9b07,NA,0,0,0,0,0,0,0
Sheetal,SEMIH,Female,02-03-2005,sheetal_semih_653@gmail.com,44f8a86233c42fd852365315ff02522b,91-9398215717,18,9,1,10,9,79,88
MANISH,Y,Male,06-06-2010,manish_234@yahoo.in,fcaa434b046790203f5a70a7b88a6a56,91-9713954499,32,65,37,102,83,33,116
Simranor Smaram,AMRIT,Female,13-03-2006,amrit@gmail.com,18f48e462954665c25cab47992be3fed,NA,0,0,0,0,0,0,0
Minati,K,Female,2009-0-28,k@yahoo.in,4179e01684a41176b498d28175190b44,91-7452269878,1,13,26,39,4,44,48
LOHAN,D,Male,30-04-2013,lohan_d@gmail.com,a420bef2cb54a97444daa0fec4aa7168,91-9284396794,8,9,56,65,7,34,41
Devilal,C,Male,06-11-2007,devilal_754@gmail.com,e3ac7046b9ed52b9bb0e09e8771ec404,91-7214235467,57,72,23,95,9,7,16
Soorat,Nripendra,Female,25-02-2008,soorat_nripendra@yahoo.in,5dbeb9e438a8517365061032be418096,91-9757597852,2,6,3,9,48,2,50
Lajwanti,SHIMON,Female,2011-9-31,lajwanti_shimon@gmail.com,00c02b2c7fd6421fdcd7282808c99a41,91-7155137214,88,35,3,38,1,3,4
Pragyawati,X,Female,07-05-2009,x@yahoo.in,6ee2fd27311a956c21c81a355491bd7b,91-7856277137,1,74,9,83,8,2,10
DAMARI,RIDLEY,Male,13-09-2009,damari_ridley_385@gmail.com,03614d1f480909aed2f97264aab33fed,91-7259615297,72,6,3,9,2,6,8
Samantha,SKYLER,Male,30-03-2005,skyler@gmail.com,2063c588f6def6b7c0e8aac9fdd1481f,91-7789447244,9,8,4,12,61,9,70
Sashi,N,Female,18-01-2004,sashi_n@gmail.com,17bfe1e448ba54c15a1c7a968590925e,91-7253748785,33,56,8,64,19,58,77
SAMIM,Z,Male,2011-0-12,samim_z@gmail.com,558cf71b656f1f328e8ce997d30b1258,NA,0,0,0,0,0,0,0
Nagina,G,Female,18-01-2013,g@yahoo.in,ed98bba23969f0bb9dd017e7d45a2c99,91-9777514239,7,29,21,50,54,13,67
ALONSO,U,Male,07-03-2010,alonso_u@gmail.com,4ef415f9e5d7fd3fac425edb434b6280,91-7476576883,34,69,4,73,1,4,5
Sati,G,Female,28-09-2011,sati_217@gmail.com,92d0650a79704121d8b2f6f2f6cbb995,91-9872259217,3,59,63,122,3,73,76
WOJTEK,Harshad,Male,18-09-2012,wojtek_harshad@yahoo.in,3e110692f8eafbe44c2c7ef6785928b2,91-8897362513,52,42,1,43,51,85,136
ELEAZAR,N,Male,05-10-2010,eleazar_n@gmail.com,10794fca74afc7ceeaff9d3dd63f7011,91-7257334967,3,8,42,50,92,8,100
Selvakumaran,TADIWA,Male,09-07-2008,selvakumaran_673@yahoo.in,2f8b239461fbbfe2fcd06800dcfb62d2,91-9565864353,2,4,87,91,4,5,9
Tamonash,KADEN-JAMES,Male,01-07-2005,tamonash@gmail.com,6a0af60b517aec3aae3816eed7c944f5,91-7564896698,7,49,77,126,27,5,32
NISHAN,E,Male,07-03-2004,nishan@gmail.com,4517104bbe1d1967262a1bc3fe0a778d,91-7562578334,4,2,95,97,4,97,101
Prachi,W,Female,06-05-2013,w@gmail.com,608d267a086d1d8920fd2d007d643162,NA,0,0,0,0,0,0,0
Dhriti,Tarachand,Female,15-11-2013,tarachand_236@gmail.com,43b0f01ddf3e1e0be6ddef99acccaa89,91-9828865564,19,2,63,65,32,49,81
Indulal,G,Male,24-03-2006,indulal@gmail.com,71413e3029a2524d5b190c6fc319f39c,91-8115842845,6,4,75,79,6,3,9
Jayant,JAXEN,Male,24-03-2008,jaxen_432@yahoo.in,3a67898b2c66ff37681598c85ccef8ff,91-9268837498,7,2,9,11,54,27,81
Yuvika,V,Female,15-06-2005,v@gmail.com,b855aa67885f5b8c6b28f8ea8f43a977,91-8216958493,16,13,5,18,24,6,30
Madhubala,L,Female,12-09-2010,madhubala_l@gmail.com,3535e8411049ef622e3b949970c838b5,91-7791551683,58,11,8,19,92,12,104
HISHAAM,R,Male,28-10-2008,hishaam_r_917@gmail.com,65d47731726a4b6e364614d5fe26cbc4,NA,0,0,0,0,0,0,0
HARVEY-JOE,Umaprasad,Male,27-07-2012,harvey-joe_umaprasad_621@gmail.com,14fff86210b2780376a05f643fd66d8f,91-7597593888,8,58,6,64,32,6,38
XANDER,DARREL,Male,20-07-2013,xander_darrel_412@yahoo.in,0a3bc1c2b2ae5f0b3476d418104a24a2,91-9278787422,31,3,58,61,7,3,10
Chapala,D,Female,27-09-2012,chapala@gmail.com,40e79990c1bf00f6e5f5a0317112fb54,91-8652489784,6,65,62,127,9,67,76
ALEKSANDER,G,Male,28-10-2014,aleksander_g@gmail.com,48fc4f471766085747da6197a4a15577,91-9561716287,6,68,95,163,2,43,45
Rachana,O,Female,18-05-2010,rachana_o_681@yahoo.in,0af6defdf6721e705d30380f0cc64c4f,91-9631949876,92,37,5,42,18,41,59
COSMIN,Teerthankar,Male,11-03-2006,cosmin_teerthankar_629@gmail.com,790a01607b75e7084f40bd9f904c0b45,NA,0,0,0,0,0,0,0
Monisha,Anupor Anoop ,Female,2005-2-29,monisha_anupor anoop @gmail.com,fe98d0ede924f19326424e97eefbe8b9,91-7897444266,47,7,4,11,21,74,95
RICCO,Z,Male,31-07-2009,ricco_375@gmail.com,361be297135ecca172304ddb6cb598fa,91-8196595864,19,78,92,170,1,1,2
Tarakini,Chinmayananda,Female,22-04-2005,chinmayananda_526@gmail.com,f298a7b1ed2ece529d935fae800d24ae,91-7666246496,76,44,1,45,8,6,14
AQIL,N,Male,11-11-2011,aqil_n_956@gmail.com,808b254cdffe984f4337eac69eef771d,91-7517932263,38,8,44,52,64,49,113
Ekalinga,REAVE,Male,30-10-2008,ekalinga_reave_893@yahoo.in,c5154fa97233e94db0602f117e84c004,91-9587943567,34,7,37,44,35,9,44
Trishul,SEYON,Male,2005-0-30,trishul_seyon_261@yahoo.in,c6844134c2d3569847c5cc4034f983be,91-8213886923,41,8,83,91,61,7,68
NARAYAN,O,Male,23-06-2009,narayan_o@gmail.com,08717304cdbc47a1c27b7f3a890edf51,91-7668874578,76,34,7,41,15,58,73
MILUN,Z,Male,30-05-2008,milun_z_468@gmail.com,de1c1ae533ed117e8b784c7c4ce5e0d0,91-9688694292,9,8,53,61,7,49,56
OSIRIS,V,Male,25-06-2010,osiris_v@yahoo.in,4da40b203b2df53b5d436a185e2e6dc8,91-9657272967,4,36,24,60,44,1,45
Lopamudra,Tarak,Female,13-01-2010,lopamudra_tarak@gmail.com,64b89172a43b059fe5fc86eb88ef0122,91-7712199881,7,82,59,141,87,7,94
Samhita,J,Female,11-03-2013,samhita_j@gmail.com,85eb7e335300094407a0e4d3022ec48c,91-7158712528,94,97,64,161,2,7,9
Hiya,Q,Female,30-06-2010,hiya_248@gmail.com,54af8a7759e557ff4adcc25931d4c38d,91-9661499778,7,15,3,18,4,58,62
Shashirekha,A,Female,23-06-2010,shashirekha_a@gmail.com,07763d022d9b404852f2725dd55352a7,91-7156673413,4,4,6,10,4,4,8
Sonam,CHAITANYA,Female,14-06-2008,sonam_chaitanya_128@yahoo.in,e1e6f730e525ddaa4f268e27bd8d8ee8,91-9354658191,9,9,4,13,1,64,65
Sohana,Arivumani,Female,09-06-2004,sohana@gmail.com,e00932ed4f39aaa2add74c950848cad7,91-9777365694,2,2,45,47,5,92,97
INDIGO,D,Male,13-07-2008,indigo_759@gmail.com,86985ddc7cc4478259aa695bc9722441,91-7125349466,55,24,3,27,2,4,6
PAVAN,X,Male,27-07-2011,pavan_x_341@gmail.com,f3c41181ba384c51ef0b3dc6ecce82b9,91-9319976342,3,8,86,94,3,34,37
ARA,N,Male,28-06-2013,ara_n_796@gmail.com,7ab6803353812194977b44e80cdad98b,91-9212468824,22,9,2,11,38,35,73
Marudham,X,Female,23-05-2011,marudham_x@gmail.com,85b93e7843f468a38b4bd91526409583,91-7577638438,3,9,45,54,71,6,77
TARUN,Z,Male,23-02-2006,tarun_462@gmail.com,2fe45ac863101bd4a633adf7a284e724,91-8637397243,3,56,45,101,35,3,38
Deshna,RYLEY-JAMES,Female,21-11-2011,deshna_ryley-james_487@gmail.com,4d8d08698fa74dfc4d2e3abe64e1b35e,91-8979926596,4,69,91,160,11,2,13
Abhijna,RIPLEY,Female,07-07-2010,ripley@gmail.com,3ec1fddf1095959b537c6918ae8ff649,91-7863121515,89,78,7,85,35,37,72
Chandrakin,B,Female,02-08-2013,b@gmail.com,5a482a44b0279ae492e702450c41c795,91-7237594796,5,51,92,143,9,5,14
JAMEEL,U,Male,06-01-2007,jameel_u_814@gmail.com,ac930b4f26a0280c44018f78b9eda117,91-7737372946,2,4,74,78,2,77,79
Pradnaya,ISLEY,Female,23-11-2010,pradnaya_978@gmail.com,1b636b106c61381c83d436b401b56260,91-7835971426,31,9,2,11,42,21,63
Swarupa,J,Female,20-10-2010,swarupa_j_384@gmail.com,d24b35a5517100320b1851f61350655f,91-9846731265,26,98,1,99,57,52,109
Tuhina,Z,Female,25-05-2005,tuhina_127@yahoo.in,cc67a1808d50839e0573dd325647d2e2,91-7843982449,96,65,76,141,8,3,11
Jayshri,ETHYN,Female,25-09-2004,ethyn_835@yahoo.in,eabbafdf7dbc5b933ea63f5c0a2ce9ea,NA,0,0,0,0,0,0,0
Isaiarasu,SHAHZAIN,Male,11-03-2010,isaiarasu_shahzain@gmail.com,14eed22e64a09d1732a25a4e588182a6,91-8684984985,8,49,63,112,94,29,123
Mohin,W,Male,2008-0-10,mohin_w@yahoo.in,622800b2c42250afead13855ab0b68e2,NA,0,0,0,0,0,0,0
Kapardini,HENRYK,Female,2006-0-14,kapardini_391@gmail.com,a864ba8b5d887fcdeda8752d9a1330f9,91-8318113255,86,1,74,75,3,32,35
Samrithi,L,Female,2013-0-19,l_852@gmail.com,d74ef4509a8a31a218a2c4ffefa258c1,91-8852456392,9,3,5,8,95,6,101
KHAN,NASR,Male,14-05-2012,khan_nasr@gmail.com,a4c75b87330125328694dc2922d67eee,91-8856743377,92,38,16,54,52,3,55
Vedi,H,Female,08-08-2011,vedi_h_192@gmail.com,a6644655f14ad6962227d861456dd90b,NA,0,0,0,0,0,0,0
SAMIULLAH,Z,Male,06-10-2010,z_842@gmail.com,7ad0a64d9085cb179105639ba1df8b9b,NA,0,0,0,0,0,0,0
Parameshwar,RONNIE,Male,12-01-2010,parameshwar_ronnie@yahoo.in,bf37a98999e91609d8ddf595bd942982,91-7214871479,38,27,3,30,65,14,79
Anumati,T,Female,09-04-2014,anumati_t_872@yahoo.in,11eefc346ee1d593dc6efef0c36a2ca0,91-9559289629,14,29,86,115,6,8,14
FRASIER,Shishupal,Male,19-08-2012,frasier_shishupal_628@yahoo.in,ec0c31096360d528cef294bdde492b2e,NA,0,0,0,0,0,0,0
Unmaivilambi,KENDRICK,Male,21-07-2013,kendrick_389@gmail.com,aa642f4229b313b2462b13efe349d557,91-8251974275,8,6,1,7,24,7,31
Mayura,B,Female,29-10-2006,mayura_b@gmail.com,15a718c22f36ea2a4f810a5ab1a9e7b9,91-7816557242,24,58,16,74,1,68,69
MATEI,HARVIN,Male,07-05-2010,matei@gmail.com,cf7f0cf23874a95f476574856f0b7d0f,91-8494758987,14,8,9,17,16,1,17
DAVIE,B,Male,07-09-2013,davie_236@gmail.com,00d19c35e197b74ff252d47563c4d8f6,91-9778631693,18,64,63,127,3,2,5
Edi,F,Male,15-02-2010,f_823@gmail.com,996359a382ece81df648270f731e5423,91-8137369356,5,5,3,8,2,62,64
RONAK,Rizvan,Male,12-07-2011,rizvan@gmail.com,45b69ebd0defca7c042057cfc1625063,91-7225247855,9,3,54,57,53,2,55
Vanita,P,Female,16-01-2008,vanita_p_381@yahoo.in,5ab2c667151ed0f710f62ff5e85e5b44,91-7733582246,8,6,9,15,74,11,85
MUAADH,Hari,Male,06-11-2011,hari_461@gmail.com,b0bdbd82059a38a208d5386fcdbb34b4,91-7822444522,1,54,2,56,9,4,13
Suhag,S,Female,24-03-2007,suhag_765@gmail.com,762b2cf9ceaf297bc2f0e29c15eb23c0,NA,0,0,0,0,0,0,0
Neeraj,Mohit,Male,16-08-2006,mohit_385@yahoo.in,0a397389b6ed042fc93cbd74902e1304,NA,0,0,0,0,0,0,0
Hansaveni,L,Female,15-04-2007,hansaveni_452@gmail.com,12f340ca7ef8251064143cf8da62dd43,91-9474158788,64,44,7,51,5,91,96
Darika,IOANNIS,Female,03-02-2013,darika_ioannis_865@gmail.com,182247a23a043f3ae92013548cea365b,NA,0,0,0,0,0,0,0
Amitabhaor Amitav ,Rebanta,Male,19-11-2009,amitabhaor amitav @gmail.com,016c0d4bac6f35bef9104d45eae95d3d,91-7276445889,5,45,8,53,5,85,90
MAREK,J,Male,2008-2-30,marek_j_724@gmail.com,ea344a87a52fd79ed70393ad138d30c6,NA,0,0,0,0,0,0,0
Radhika,ZYON,Female,08-08-2006,radhika_zyon_281@gmail.com,c839895f3ce14c0f8e85cb4b50211194,NA,0,0,0,0,0,0,0
Manikandan,HASAAN,Male,21-04-2009,manikandan_hasaan@gmail.com,8909aa2abd4596dec036896ae9b08e3f,NA,0,0,0,0,0,0,0
Mehbooba,HENSON,Female,04-06-2007,mehbooba_henson@yahoo.in,3e671677977c901a445a402759919c89,91-7355342837,79,85,7,92,28,2,30
Purnendu,KARAN,Male,10-04-2006,purnendu@yahoo.in,d23a983c1ef7191b81e1fe25725d2fdf,91-7388933692,63,5,53,58,53,1,54
Kusuma,AYOOLUWA,Female,20-06-2011,ayooluwa@gmail.com,5c01e445b1a8ecc0a7b946d31ca9d494,91-7899646282,22,45,8,53,7,4,11
TEON,I,Male,27-05-2009,teon_i@gmail.com,4ed30c5934ff61c27ef2a9c6ee838b4d,91-9872885234,75,22,2,24,4,1,5
Vikesh,O,Male,17-04-2008,vikesh@gmail.com,f99c9890e848599b158e5aa546c751ec,91-8976298212,38,3,74,77,31,4,35
JAXXON,K,Male,07-05-2011,jaxxon_k@gmail.com,7594cd9be33892ea43b032293fdcde3a,91-9117531598,2,82,29,111,3,64,67
Madhumati,Sahil,Female,23-09-2011,madhumati_sahil@gmail.com,a0c8fb9f8fe321bc9242e7da818f5376,91-9476898464,73,64,2,66,78,4,82
Reshma,FAVOUR,Female,2006-9-31,favour@gmail.com,65e1e392d7a2814cca190b9fc9508afa,91-7941445954,4,7,93,100,8,14,22
Anasuya,TAVION,Female,07-07-2006,anasuya_tavion@gmail.com,9b6e4f7a335a5e52c96fb2af80cd3a72,91-7699313553,3,52,6,58,2,85,87
Raksha,K,Male,16-06-2009,raksha_k_973@gmail.com,99dba962f571b95ead6c0ab47638306a,91-9552192313,5,1,52,53,9,65,74
CAMERAN,N,Male,05-06-2005,cameran_n_938@gmail.com,adeb7d494fca72ec728dfeb458fc7522,91-7358178831,1,43,2,45,77,99,176
Debanshi,N,Female,28-09-2005,debanshi_n@gmail.com,9909b51f435aa427c3c6ac2725a8bd92,91-7728525631,5,35,5,40,7,2,9
Rajivini,JIBRIL,Female,21-02-2011,jibril@gmail.com,3b109e6b134ff0d14dd0eb4a9527d34d,91-7674383333,7,13,45,58,72,2,74
Ishana,L,Female,02-11-2005,ishana_l@gmail.com,c172dc4eb4359445e23a4e0a47cccb44,91-7378672651,92,2,5,7,85,86,171
Aslesh,MITHUN,Male,06-04-2008,mithun_543@gmail.com,d151c4b7ea52ce49e2a77732d2c12a18,91-7679548847,5,75,72,147,19,5,24
YOOSUF,JOHNATHAN,Male,2010-6-31,yoosuf_johnathan@yahoo.in,84d37ef40f440064b7b7fdf5ab8b2091,91-8572627655,4,7,1,8,66,1,67
Mita,J,Female,23-02-2008,mita@gmail.com,3773470a043f89ccd46c5f2bbbfa1be0,91-8952829843,45,2,14,16,64,49,113
ROMEO,Khajit,Male,03-08-2004,romeo_khajit@gmail.com,a694eea79d81f32afd7af158b42d1309,91-7941325629,34,3,18,21,42,8,50
Kumud,HAYDER,Female,17-06-2009,hayder@gmail.com,91acfac29e52117eec592d484fc3fe14,91-9697356915,5,4,6,10,89,9,98
TIRTH,DIAMOND,Male,19-11-2004,tirth_diamond@gmail.com,08fa22140e97e0799054f3e25e95705a,91-7417426924,6,66,48,114,42,9,51
ANDRZEJ,V,Male,03-10-2005,andrzej_v_968@gmail.com,eb37d92cf23356d33b168d6a24273f94,91-7254243559,3,1,38,39,72,37,109
CAIDON,S,Male,20-11-2009,caidon@gmail.com,6f409a9fac4b1367c2d64a87c2febe4f,91-7389921782,41,14,17,31,5,9,14
Lohita,C,Female,28-11-2006,lohita_c_562@gmail.com,c84f201b60e98771aed17e6e2e0962c7,91-7381651956,9,9,6,15,48,8,56
TASHINGA,F,Male,01-05-2008,tashinga_f_781@gmail.com,672e3809d452b8f6209a9d5b6acdc13d,91-9174918379,68,9,1,10,7,39,46
Devasmitha,Nityananda,Female,2011-0-28,devasmitha@gmail.com,baf595f00d2226a10fe3a278b907a9bd,91-8393298688,59,67,3,70,97,61,158
Nirmayi,I,Female,27-04-2011,nirmayi_893@gmail.com,54721b753b117ebbbcafebbf278b2aae,NA,0,0,0,0,0,0,0
Simritor Smrita,GAGE,Female,05-10-2008,gage@gmail.com,cb72763a4fb3eeb157f59fa43e32d904,91-8931816225,5,15,3,18,15,4,19
Ekadhana,Anunay,Female,01-03-2006,ekadhana@yahoo.in,0c0e02c2359ff00b379c549ee66a8d73,NA,0,0,0,0,0,0,0
ROKAS,ILYES,Male,04-11-2009,ilyes_829@gmail.com,c61638bbd612297ef812132d11b81bea,91-9454978595,9,39,9,48,2,8,10
LUCIUS,L,Male,23-03-2009,lucius_486@gmail.com,f01d5b3d5d724b0e8c058e941bd2cbd0,91-7471324488,2,7,91,98,19,3,22
Simranor Smaram,AMANI,Female,16-11-2008,simranor smaram_amani@gmail.com,e3e85b92b61259976c56f1f4da61843e,91-9457269522,4,9,9,18,1,59,60
AYOBAMI,OSAMUDIAMEN,Male,10-06-2013,ayobami_osamudiamen_246@gmail.com,b06410ecc9f33d499a6d319b1170d8fa,91-7373223286,4,4,43,47,91,2,93
Nimisha,SAVAS,Female,26-08-2014,nimisha@gmail.com,8140d0688ededc9a4c3c298f60d9755c,NA,0,0,0,0,0,0,0
KRISTAN,CLAUDIO,Male,07-02-2014,kristan@gmail.com,e17af30ae141e2f3b628aafa07a2a973,91-8967297218,8,5,86,91,11,9,20
Kapardini,JUBRIL,Female,28-09-2011,kapardini_684@gmail.com,40f6a9330c41c254d6ffbec07ace79f8,91-9893173614,1,64,7,71,77,13,90
Bhuvan,SHAQUILLE,Male,2014-6-31,bhuvan@yahoo.in,ef256cc1b5aeab8a81eae6475344dccd,91-8912495316,9,25,9,34,68,4,72
Jagavi,A,Female,26-05-2007,jagavi_a@gmail.com,4e91e49c6242173c2a8897874022a0d8,91-7132798491,8,57,72,129,73,9,82
NOSAKHARE,H,Male,17-05-2012,nosakhare_h_928@yahoo.in,7bc70da74fae436899d9eebcfd40b144,NA,0,0,0,0,0,0,0
Faiza,P,Female,25-11-2011,faiza_p_893@gmail.com,8b685403cd6f388e7de828888fa4bf0e,91-9314889542,71,55,1,56,63,42,105
Pyaremohan,FILIP,Male,16-09-2011,filip@yahoo.in,0af49a18a740c6cbd090e140ee37c2ee,91-7248292415,1,6,92,98,3,95,98
GONCALO,ABDILAHI,Male,2008-0-11,abdilahi_726@gmail.com,9df87d6ae43b4d51499107da4c57f924,91-7473492589,24,97,6,103,5,5,10
Virata,A,Female,02-05-2010,virata@gmail.com,5a007c21e847c39ecf74d30acd391e4e,NA,0,0,0,0,0,0,0
Mangalya,C,Female,18-11-2009,c@gmail.com,4de929b51836219759542c80041dad40,91-7534555279,51,78,2,80,4,64,68
Idhitri,Z,Female,19-02-2009,z_735@gmail.com,f3cefa74c4bc290521513ea1eaf39adf,91-8617724633,28,9,89,98,8,2,10
Grahish,V,Male,21-07-2012,grahish_v_451@gmail.com,4a30b7dc92a865a6bd6de990c3817d9b,91-7225979355,55,68,27,95,33,9,42
DILAN,IRTIZA,Male,02-10-2012,dilan_irtiza@yahoo.in,829ea77b3cb28961b54e98714ce462d6,91-8325343567,44,8,6,14,92,97,189
IANIS,RAMONE,Male,02-03-2009,ianis@yahoo.in,63168905d4bf8126d26353edf321e6ac,91-7816856449,9,9,1,10,58,3,61
ESROM,RONIT,Male,11-01-2005,ronit@gmail.com,776a5c986b4a5cc1445d2b283cb2f921,NA,0,0,0,0,0,0,0
Madirakshi,G,Female,24-03-2014,g@gmail.com,13147ad50ff8819b84cf2377b69944d3,91-7528743966,9,6,1,7,9,1,10
Grhitha,ALBY,Female,16-08-2013,grhitha_alby@gmail.com,a26047d77c8997e3b984ee7d6a197176,91-9899466551,3,9,19,28,2,9,11
BOB,CADEN,Male,22-10-2007,bob_caden_279@gmail.com,091d68e27a75629ff8ac83099d890d4d,91-8499472956,66,73,2,75,5,2,7
ASHA,U,Male,25-07-2010,u@yahoo.in,09e729e1b99a425d951caed123b1e7c6,91-8247778558,86,76,5,81,7,8,15
Harithi,B,Female,23-07-2012,harithi_b@gmail.com,be52a8e1b06e2806128a63b7d0782514,91-7111116792,8,2,41,43,4,91,95
Kashi,J,Female,15-02-2011,kashi_j@yahoo.in,3419e9d43d57e27998e723ddc27ee8b8,NA,0,0,0,0,0,0,0
Pulin,M,Male,05-08-2013,m_327@gmail.com,6b5d0e07c4799a0fcff5af17221c4d2f,91-8165844198,88,8,37,45,6,18,24
Timila,SALIM,Female,2006-0-27,timila_salim@yahoo.in,1bc80858ce28ea2e5cc9f1ee8839ad0a,NA,0,0,0,0,0,0,0
BOE,Z,Male,07-04-2008,boe_z_689@yahoo.in,74db275612358a35531050bec38fe468,91-7149646545,75,4,27,31,3,97,100
Saroj,WARWICK,Female,01-07-2007,warwick@yahoo.in,d8e7b1c8e80e1aa5a37f887e52bc11c1,91-7328754563,55,7,5,12,95,46,141
Sankul,N,Female,2007-0-15,sankul_n_542@gmail.com,1a297c48abdc3b8311f427b630a78782,91-7569415992,99,7,32,39,4,63,67
Tusti,C,Female,14-03-2011,tusti_c_683@gmail.com,ba4b4125eb68705d0454c7e9fae4693c,91-8266733374,56,8,4,12,97,92,189
Rupashri,Gulzar,Female,26-07-2009,rupashri_gulzar@gmail.com,54bf46991fa735c324bef9e952be2b59,91-9118456613,45,4,3,7,76,3,79
MARCELL,Omprakash,Male,16-10-2006,marcell@gmail.com,7d7ee47fbcb85b7ef9a7d0039b14b0b8,91-8961674766,4,6,34,40,94,87,181
Chitrita,X,Female,2007-0-31,chitrita_x_183@yahoo.in,4dd5c7cc0fc94a631290b3867ab18f22,91-7773432352,13,6,6,12,75,2,77
Shrinivas,N,Male,17-07-2009,shrinivas_n_279@yahoo.in,405be847ec74cabdc88bd27c60b9aead,91-8945162967,18,67,2,69,73,84,157
Rajendra,Purujit,Male,17-01-2012,purujit@gmail.com,a235cf070c717613181aa52fabf5eeb3,91-9389581692,8,77,9,86,3,5,8
Shaila,SHERIFF,Female,16-04-2004,sheriff_796@gmail.com,5f90cc9e06f41b0f49fd632a5e1ffe6e,91-9295572348,81,37,75,112,29,7,36
Doyel,CARSEN,Female,05-05-2012,doyel@gmail.com,617cff7a5063ea336a405cbe8bdf8787,91-7325591241,7,53,2,55,3,3,6
VIGNESH,E,Male,17-02-2012,vignesh_e_184@gmail.com,561cb4a2d8aed792e24a84ad4c9c8334,91-8313774456,2,66,84,150,5,4,9
LARS,ADAMA,Male,03-09-2006,adama@gmail.com,a996401b9955c0f3f16cd398c1149cb1,NA,0,0,0,0,0,0,0
MAMADOU,O,Male,09-04-2009,mamadou_o@gmail.com,348de1dd2902ad1ea1fd43aef3c4071e,91-9724187953,94,28,6,34,5,6,11
SAMUAL,SENA,Male,24-08-2006,samual_sena@gmail.com,cc238024030c385cc5f3d91fc5813499,91-9532219594,77,9,8,17,87,6,93
Lalitmohan,YUSAF,Male,09-02-2010,lalitmohan@gmail.com,f8eb688595f5220a1c6c59eee389e8c9,91-7973732187,89,3,58,61,9,15,24
Suchira,REX,Female,22-02-2007,suchira_rex@yahoo.in,b3ff42d6a18baa6691a9db5b6ef9261d,91-7783996123,98,2,15,17,12,68,80
Muthammal,MERAJ,Female,11-07-2009,muthammal_meraj_752@yahoo.in,de59b7fa130ca0fa4cb1f3dc875aee09,91-8922354278,74,65,9,74,3,6,9
Arati,DRACO,Female,07-01-2006,arati_draco@yahoo.in,70b77d067811c8e56a1384a4bcc892b0,91-7582539466,4,7,5,12,68,6,74
Malti,V,Female,22-08-2010,malti_724@gmail.com,c590a5453683455910cbd01e4fec2152,91-7921174847,6,8,75,83,57,27,84
Phanindra,K,Male,08-09-2010,phanindra_k@gmail.com,8a793ab4568f173cf2bff75ecebbe92b,NA,0,0,0,0,0,0,0
KEANO,NAFIS,Male,20-07-2012,nafis@yahoo.in,2024cdd3937b08bbe24b43010cc34e6c,91-9418462195,93,8,4,12,3,19,22
Ruma,D,Female,05-09-2004,d@gmail.com,46ebef09245eccc41813de77499e6894,91-7728846146,9,68,68,136,3,53,56
Wamika,G,Female,30-07-2007,wamika_g@gmail.com,2b0d75e1dd486be8fdc693466a2d85e5,91-7179868365,4,9,45,54,22,28,50
BARAN,SKY,Male,14-01-2007,baran_sky@gmail.com,cd41d4d190f4f1e15db4fb4523464b09,NA,0,0,0,0,0,0,0
Medhani,G,Female,08-06-2010,medhani_g_679@gmail.com,be17c2044a561960f57f61c34094182e,NA,0,0,0,0,0,0,0
Tanmaya,Vedavrata,Female,03-08-2014,tanmaya_vedavrata@gmail.com,c43d42739c1d2cd111e157e8792ca1b0,91-9487541916,46,3,54,57,9,9,18
Mukti,V,Female,2014-0-12,mukti_v_618@gmail.com,55bf792a6dec907e2df83dd6d49a3805,91-8939952513,1,79,72,151,3,67,70
Chakradhar,SUDAIS,Male,05-03-2006,sudais@gmail.com,a56651047c24779d785bda43fd8371c5,91-7976592474,73,5,65,70,13,2,15
Holika,G,Female,19-11-2010,g_517@gmail.com,1f5ca0949a4bc29e2528b1ae7dbcd673,91-8617685882,14,46,4,50,7,74,81
Tamalika,TUAN,Female,27-11-2007,tamalika@yahoo.in,6f181adc77cd413d891de156b37fcda5,91-7437919975,6,33,46,79,83,2,85
Sulekh,EESAA,Female,13-11-2010,eesaa_645@gmail.com,1cbd634e4c6d6aafcf2dba2a5bfdc0a3,91-7851651474,7,1,3,4,7,3,10
Yamini,Y,Female,05-01-2009,yamini_y@gmail.com,703baa891dd1b22533dbfea94e3e6f64,91-7818392632,27,5,1,6,65,12,77
XAVIAN,F,Male,2009-0-14,xavian_f_519@gmail.com,fc526324d970555bb134698ffdc70234,91-7296433295,12,8,4,12,7,22,29
SHOMARI,V,Male,06-06-2012,v@yahoo.in,9704b87dfd56687d125ac73cd0986475,91-9627788356,2,8,54,62,2,14,16
ALFIE,P,Male,15-07-2005,alfie@gmail.com,e032f83fd9e01ec6ead4137cb4c25599,NA,0,0,0,0,0,0,0
Mahadevi,DOMINICK,Female,05-04-2010,mahadevi_dominick@yahoo.in,a42357974a4417397a765de474f82d2f,NA,0,0,0,0,0,0,0
YUSHA,Geet,Male,04-04-2009,yusha_geet@gmail.com,99825b22181985d1f04798aa083891f6,91-7572744516,23,9,5,14,32,45,77
Kanakabati,ERDEM,Female,03-07-2008,kanakabati_erdem@gmail.com,069585010c37b970cd45420c1f51986b,91-7631575711,76,96,46,142,6,6,12
Thirumani,Faris,Male,06-04-2010,faris@yahoo.in,963c69a493d24e5fd55ef4f133e73a41,91-7973695135,38,88,8,96,27,2,29
Chandrakin,B,Female,2012-0-21,chandrakin@gmail.com,5a482a44b0279ae492e702450c41c795,91-7867196712,2,63,1,64,23,4,27
Sampatti,PHARRELL,Female,14-11-2006,sampatti@gmail.com,029063c8e2e4279c217d6c97a35916da,91-8836943252,61,74,24,98,3,3,6
KELLAN,W,Male,2013-0-19,kellan_w_164@gmail.com,3abfa64c09a952c7d0d3d2616d6eb2b7,NA,0,0,0,0,0,0,0
Surya,R,Female,10-10-2013,surya_r@yahoo.in,caa66a8bc2fbaa6910a58b69db7ce4de,91-9459355728,76,33,38,71,61,66,127
Chiti,U,Female,24-08-2008,chiti_u@gmail.com,7e3f2d2a08e0501be70f855714556864,91-9412878525,43,8,6,14,33,4,37
Manasvi,KONRAD,Female,20-03-2010,konrad@gmail.com,87b905d8d48c51e2cce6e87fd5ac3f96,91-9149694751,1,5,91,96,61,2,63
Lavali,S,Female,02-02-2006,lavali_842@yahoo.in,c02323684cb90fc492e25d0bc9a3aeed,91-9117337428,6,75,67,142,68,7,75
Mithi,ELIJAH,Female,27-04-2004,mithi_elijah_419@gmail.com,f6bd95c2223a74af43dcc385a9b71290,91-8289981583,9,34,97,131,44,5,49
ZIDAN,A,Male,23-10-2014,zidan_a_816@gmail.com,0707edea81f107df9c32727b7791fe55,NA,0,0,0,0,0,0,0
Pankaja,HAREEM,Female,27-06-2008,pankaja_hareem@gmail.com,4b5e5b94585858f2b0b3ac3dbffe9f34,91-8343844339,44,2,81,83,12,18,30
Prita,A,Female,20-08-2014,a@yahoo.in,090a7d5074e139881228ee5bec50ac6a,91-7354192642,33,5,8,13,82,5,87
Pachaimuthu,Rituraj,Male,05-03-2014,pachaimuthu_732@yahoo.in,ff560430d07ff2968a9d897040ed1204,91-7583121218,65,8,5,13,3,31,34
Smriti,EZEKIEL,Female,15-06-2012,smriti_ezekiel@gmail.com,76222bf59f471b3198888cd4f5b95753,91-7679732955,5,32,1,33,6,9,15
BRENNAN,DEREK,Male,21-07-2010,brennan_415@yahoo.in,c68b573aa9b07a867421146f0bff00d8,91-7944765283,95,7,43,50,1,9,10
HALEN,OSAMUDIAMEN,Male,05-08-2010,halen_934@gmail.com,838865bb7dd4e9a0870ebe7402305809,NA,0,0,0,0,0,0,0
GURTEJ,STIRLING,Male,03-09-2006,gurtej_stirling_259@gmail.com,7333addb04c18dac9e74194be32025c4,91-9438535742,76,3,64,67,4,38,42
Rangitha,JOESPH,Female,16-10-2010,rangitha_joesph_971@gmail.com,0060db809ff26a702719601bb83e737b,91-7729639658,3,39,1,40,6,6,12
Charusheela,F,Female,13-05-2013,f_746@gmail.com,40ff79753289659625aee43c81c9bc3b,91-8229158365,8,2,51,53,4,71,75
Kamalika,RILEE,Female,2014-0-11,rilee_429@gmail.com,314a4172856121c348712b6d02e7cae0,NA,0,0,0,0,0,0,0
Anuradha,LELAND,Female,07-11-2005,anuradha@gmail.com,5131c0ff605792bbac1febc7861800f2,91-8188936679,3,8,73,81,54,14,68
JAYCE,R,Male,24-03-2013,r_543@gmail.com,0902745efc729f5f455f76659acb75bb,91-7482986266,1,8,53,61,2,17,19
Sudakshima,Q,Female,27-03-2013,q_961@gmail.com,ad820e5fa782c74c97bf9f4265a155c9,91-7363462413,15,53,13,66,33,3,36
Somnath,D,Male,12-09-2008,somnath_d@gmail.com,054b587435ce52d98fcb4999a0245a17,91-9987582427,16,77,9,86,26,8,34
Saeeda,ADEL,Female,09-04-2013,adel_928@gmail.com,533a3221380c41959c91edaced9f078a,91-9234484615,2,53,39,92,6,5,11
Kanchi,N,Female,25-05-2012,n@gmail.com,b748fafd927091d98b88d739e0a8bbee,NA,0,0,0,0,0,0,0
Indira,Bankim,Female,16-08-2007,indira_bankim_863@yahoo.in,eade3b3fb6bc79438cc4f8652fad2e59,NA,0,0,0,0,0,0,0
Abhijna,Kripal,Female,2004-2-31,kripal_516@gmail.com,c3bcc4f69c50c41d0d2ba75315e21866,NA,0,0,0,0,0,0,0
MAXIMILIEN,C,Male,07-09-2005,c_615@gmail.com,e700d6806d8ad3fbd2ee29524ade6530,91-9172718374,3,5,61,66,98,2,100
Jharna,JAD,Female,11-10-2011,jharna_jad@gmail.com,039e945468b88fb39f7352ac6a9e5aa6,91-9662618674,92,4,3,7,15,2,17
Nupura,Q,Female,14-03-2014,nupura_q@gmail.com,0bfd47987b63c6baedcde51699047f76,91-8727751884,37,61,4,65,96,3,99
PRABHJOT,A,Male,2013-0-2,prabhjot_a_541@gmail.com,f6d9c285196c82f4a0f18511769bbfb4,91-7348783961,53,16,9,25,3,44,47
Priya,F,Female,24-07-2007,priya_f@gmail.com,dbd2cb97514d09c906e90bf2eb07df36,91-7342575474,3,9,3,12,94,91,185
Shrikumari,F,Female,17-03-2009,f_859@gmail.com,5afc9bc10b6add463e98bd5ea67ac229,91-8221588799,28,1,8,9,54,9,63
ALVARO,Z,Male,06-05-2009,alvaro_359@gmail.com,f9241d1d56760eb539b2b0cab917b0f5,NA,0,0,0,0,0,0,0
PARKER,Vidur,Male,2006-2-29,parker_vidur_941@yahoo.in,167b5bd42d70192fe83da79f4f57b824,NA,0,0,0,0,0,0,0
HEZEKIAH,MAISON,Male,29-08-2011,maison@gmail.com,7f3ccb4c9fe5e7dfc16e524cefd64fff,91-7631827231,3,6,9,15,4,79,83
Nilasha,N,Female,28-03-2013,nilasha_n_497@gmail.com,4aae82b711c580ed0db67143dc110c88,91-9357592388,1,1,41,42,4,5,9
BILL,C,Male,10-06-2008,bill_c_362@gmail.com,dfe4c9f540a39d3127fce772eaf8771a,91-9687659328,25,32,1,33,43,1,44
ROKAS,C,Male,05-04-2005,rokas_c@gmail.com,ebd2ec61c98942b39871d43cc3197b80,91-7339175311,4,77,7,84,94,85,179
ROMAAN,IOSIF,Male,22-02-2008,romaan_649@gmail.com,bbe05591f88c276853297747e77dc714,91-8484952268,1,41,3,44,7,4,11
CHI,D,Male,13-04-2009,chi_d_961@gmail.com,0a35e4ae97f62709b342ebbf97d29094,NA,0,0,0,0,0,0,0
Pralay,Talat,Male,27-06-2011,pralay_talat_517@gmail.com,01a8af6827fb50b623f74470af742ebf,91-8128568975,79,64,76,140,8,44,52
TAMAS,L,Male,03-11-2008,l_124@gmail.com,afc9c73db9fa8675f9604656902b3037,NA,0,0,0,0,0,0,0
SAHIBJOT,J,Male,2006-11-31,sahibjot_j_725@gmail.com,6447f38833334bdfb7e1f501f18b3a0a,91-7715133528,3,77,9,86,8,33,41
Kurangi,S,Female,10-11-2012,kurangi_s@gmail.com,dc3ab88189a37089b193b4b20de616c6,91-7623416871,6,5,91,96,44,57,101
Poornima,Sarup,Female,2007-0-10,poornima_759@gmail.com,60bc531ab62ddc8be6810d60bae6e86e,91-8218841459,87,35,39,74,9,4,13
PRANSHU,B,Male,14-08-2013,b@yahoo.in,ce0317aa4433df8577070ac81c0477c2,91-8172414256,4,4,3,7,4,5,9
Dheerendra,Pathik,Male,16-04-2005,pathik_176@gmail.com,96ed93b5d43ca24d89dcb7d06c552624,91-7157716863,34,77,37,114,2,57,59
Charu,WARWICK,Female,08-07-2011,charu_warwick_821@yahoo.in,cb846f2a40fd722ab2ca320577513b9d,91-7478919639,26,64,13,77,2,6,8
Ashakiran,Q,Female,25-11-2008,q_483@gmail.com,6a4890680df6746893b17df88013746b,91-7818685293,14,6,5,11,44,8,52
DENIS,O,Male,06-10-2014,denis_o_186@yahoo.in,c0e17f636da4f55b753458e00f2ccb07,NA,0,0,0,0,0,0,0
Yogini,Fanindra,Female,2011-0-16,yogini_fanindra_715@gmail.com,ed25b8025eb642c9547b1c3844672074,91-8964897925,68,69,27,96,11,2,13
Brijmohan,Fuad,Male,10-02-2012,brijmohan_fuad@gmail.com,edffbd7871b6663ab27b6b352f453a6d,NA,0,0,0,0,0,0,0
FRANTISEK,R,Male,20-11-2014,r_128@gmail.com,7f4457f344a7687b4be7892e50f7d2d7,91-7762976952,6,74,99,173,6,1,7
Leena,T,Female,04-09-2007,t@gmail.com,a2b18cf630417098b37cbfca5b4bff1e,91-9627895557,55,9,93,102,9,6,15
Padmalaya,Y,Female,08-01-2011,padmalaya_y@gmail.com,1f2e6b86d5d6e9847f250802169e3dcf,91-7239939736,11,71,4,75,71,6,77
Subhashini,D,Female,27-07-2007,subhashini_d_516@gmail.com,0512a417cd51ddba1182d81325d7b533,91-7917663471,2,87,6,93,2,89,91
Lagan,O,Male,2013-0-3,o@yahoo.in,a03af5c720157a3fb65b661cc09be455,91-8339862173,94,6,8,14,61,5,66
Lavangi,E,Female,28-04-2004,e@yahoo.in,ca4f21b93a096bc48998051ccd8f5218,91-7127597743,94,36,53,89,6,86,92
Ranjita,I,Female,01-08-2008,ranjita_i_381@gmail.com,c9bda8f38766e919e2e3bac6af184d0e,NA,0,0,0,0,0,0,0
AIRONAS,Q,Male,17-06-2013,q@yahoo.in,cfbfcc3b53cf963530429c5cf33dd72b,91-9189549813,4,78,8,86,2,5,7
HARPREET,JABEZ,Male,17-09-2012,harpreet_jabez@yahoo.in,5c6af14ace2a671e06613f7a892e8b1d,NA,0,0,0,0,0,0,0
KANISHK,L,Male,23-07-2009,kanishk_l@gmail.com,abd1357b61cec1d861f70adf408f587d,91-7581119382,3,14,77,91,78,95,173
Tarala,Q,Female,05-01-2006,tarala@yahoo.in,5bb012b50cad5104ea0d3c0378138456,NA,0,0,0,0,0,0,0
RYU,P,Male,16-09-2011,ryu_784@gmail.com,fbf13e3cd453c0c5de9b38d014a34674,91-7858486557,91,15,45,60,66,4,70
Krishnachandra,Madin,Male,2011-0-29,krishnachandra_madin@gmail.com,2151636cfcf60ac3e6ba4c8e670f05a9,91-8963337614,8,2,48,50,96,33,129
LAYTON-JAMES,RUFUS,Male,05-02-2014,rufus@gmail.com,b2828f0df4d72438f2fa4aa9cc29e01f,91-9855637939,3,6,51,57,7,47,54
SOMTOCHUKWU,Punyabrata,Male,03-01-2008,somtochukwu_195@gmail.com,378481564cc1e61f11cbf1cbf98746b1,91-7143597183,21,1,7,8,84,71,155
ZAID,S,Male,02-07-2014,zaid_s_345@gmail.com,db43ee69e07ed2eebb4ff709a1e68d49,91-8677811343,67,97,89,186,17,91,108
TIAN,COBEY,Male,23-06-2010,tian_cobey_178@gmail.com,a1f2260e75a74dd9d7240c886a9c0313,NA,0,0,0,0,0,0,0
Sarama,X,Female,2008-0-19,sarama_821@gmail.com,081c5cbd487219db4d36c7fb17459680,91-7545524522,8,17,1,18,41,64,105
WAYNE,Y,Male,04-01-2013,wayne_y@gmail.com,eedacca64a52bd5ae6b32255b769efb7,91-7823397599,14,23,8,31,5,15,20
Sachita,M,Female,19-03-2008,sachita_m@gmail.com,057f478fde183356d0e5a8d62855f00d,91-8716841346,9,39,81,120,4,75,79
LOVELL,R,Male,18-11-2006,lovell_r@gmail.com,76be015932b18138996816eca0d6f503,91-9839457678,9,51,41,92,74,9,83
Mohitha,A,Female,21-10-2013,mohitha_a_641@gmail.com,cea31ec805d58699d057623799651204,91-8914253355,3,68,12,80,93,72,165
PERCIVAL,O,Male,21-08-2010,percival_o@yahoo.in,67f9d7fb42c4e0fd18d0791b9f7788be,NA,0,0,0,0,0,0,0
Smriti,KRISHIV,Female,01-10-2004,krishiv@gmail.com,e347943e58f28ce92df826be9116fd71,91-9794514738,48,56,86,142,25,68,93
OISIN,MOHAMMED-IBRAHIM,Male,09-01-2011,mohammed-ibrahim@gmail.com,046d9f82e032ab5ce387da3a18d8f39f,91-8884252492,14,1,8,9,36,89,125
Swagata,U,Female,19-02-2006,swagata_172@yahoo.in,1d7c90cabebce9adbf41ecc384bda0b2,NA,0,0,0,0,0,0,0
RAFE,L,Male,28-02-2006,rafe_l_847@gmail.com,de419a668a11269f534031f1fdd181cc,NA,0,0,0,0,0,0,0
Suhitha,D,Female,15-10-2005,suhitha_d@gmail.com,e7c97d78d7aa458404cfcfbf13333c2a,91-9669992458,6,18,34,52,8,67,75
Pia,Thangasami,Female,2012-0-11,pia@yahoo.in,9e7f708a6062b9a1d62a60b4b0d34614,91-7646246876,69,3,7,10,5,76,81
DWIGHT,DAINTON,Male,20-06-2007,dwight_dainton@yahoo.in,1785877ecfeaa571d056f3733e97ba8c,91-7149892666,4,53,2,55,86,41,127
HARPREET,ISMAEEL,Male,10-02-2005,harpreet@gmail.com,bba370e0210f86499b8a3bfb8d1f5db3,91-7735824225,86,52,9,61,2,2,4
ARSHMAN,DHANYAAL,Male,28-09-2012,dhanyaal_173@gmail.com,b5ef5d2d6298049feb43c9796782d5f8,91-8989425672,95,8,64,72,56,25,81
ARYA,Q,Male,01-07-2011,arya_q@gmail.com,adaf16adee8788905a56e2c6c7aea191,91-7511788885,74,7,4,11,6,28,34
Acaryasuta,O,Male,2012-2-31,acaryasuta_o_496@gmail.com,c40e35f939b053392922d517275ed41e,91-7463553836,1,9,58,67,6,81,87
Trisha,Radhavallabh,Female,05-10-2006,trisha_radhavallabh@gmail.com,20e9769b3ac765bb76b24f1567171daa,91-9513381894,3,48,92,140,11,7,18
Ulka,R,Female,11-06-2005,ulka_r_261@gmail.com,b6e62298a2eacd0b3ca401a27004b2d8,91-8566945957,13,7,19,26,9,8,17
APOLLO,Z,Male,2008-0-26,apollo@gmail.com,8a2a22a500d51654d91465e5b6a33ff8,91-7463127169,19,16,71,87,69,93,162
Pia,X,Female,17-01-2012,x_589@gmail.com,b86aaf40cca3af2867c1b7b10142cc6f,NA,0,0,0,0,0,0,0
Purumitra,F,Male,28-11-2008,f@gmail.com,e7d1e67a2573f522c6596b7d3213de9e,91-9455552877,9,6,39,45,25,17,42
QI,P,Male,10-11-2007,qi@yahoo.in,0a203bcf91535a11fb909ce8b499ffb0,91-9794284597,96,26,9,35,4,79,83
Pingala,C,Female,23-08-2011,pingala_c@gmail.com,fcfb6ed3948008986fbe354b5f4f8130,91-7828224586,49,3,44,47,42,66,108
Hasina,LIAM-JAMES,Female,23-04-2014,hasina_liam-james@yahoo.in,618d51cdc64bdbf2c967a341b9b9594a,NA,0,0,0,0,0,0,0
Manorama,BRYNLEY,Female,24-01-2013,manorama_brynley_956@yahoo.in,445fd98bd3f2dcf1bb2e3fc716e87300,91-9288925763,99,6,22,28,6,79,85
Sachika,Acarya,Female,20-05-2011,acarya@gmail.com,8f2c842f552c71f14717875d1698bea0,91-7222276431,19,7,1,8,3,96,99
Archana,O,Female,27-02-2012,archana@gmail.com,451c594e82396dbb0da6b3eb27d02469,91-7611283553,5,95,23,118,76,2,78
UBAYDULLAH,JONAN,Male,13-05-2010,ubaydullah_jonan@yahoo.in,c7795774168efc42a63a38aefe0c85b1,91-9761626657,22,34,72,106,9,5,14
Baridbaran,Kartikeya,Male,2012-4-31,baridbaran_kartikeya_743@gmail.com,6d9e5c4c9f45b1e344bbe4ec0140d551,91-8212477316,32,8,1,9,7,19,26
IVOR,S,Male,09-06-2010,ivor_s_731@gmail.com,e0456ff4a3ca19e71520048dcf4d33a0,91-7482436363,7,8,68,76,8,55,63
ABDULLA,F,Male,08-06-2012,abdulla_f@gmail.com,890ccaaf94ffe6b1bdc8bdf50c822ae0,91-8162763787,1,9,9,18,5,6,11
Trusha,H,Female,05-07-2004,trusha_h_582@yahoo.in,5471b6b45cd25080ca910d2695ecc5f8,91-7568752246,69,27,6,33,86,7,93
HARON,Y,Male,01-05-2012,y@yahoo.in,e26a783a830cf224ac3d6ace55f4ed8a,91-7463858697,7,44,72,116,69,8,77
Sumana,HAKIM,Female,19-06-2005,sumana@yahoo.in,2f70f7d36d54c88426f5bb83cc5e1c56,91-8744635377,22,24,98,122,89,8,97
Suniti,Q,Female,29-05-2006,suniti_q_719@gmail.com,d9dafc475a7677a86d8c91a3dce646e7,91-9917525727,35,9,18,27,75,37,112
NAWAZ,L,Male,28-07-2008,nawaz_l@gmail.com,910001af5901462f3062cab95844e0c9,91-9848475713,5,58,8,66,19,52,71
SHEIK,ADRIANS,Male,2013-0-23,sheik_adrians@gmail.com,8e163ee62e46f1f6721d472282603dd0,91-8557528529,4,1,65,66,1,7,8
Rameshwari,DARRYL,Female,09-08-2008,rameshwari_darryl@gmail.com,96a86ac447cbaec3b4f93f11896c0b49,91-7276755624,8,77,71,148,38,8,46
Sarala,A,Female,06-07-2013,sarala_a_857@gmail.com,aae45536d2422baa3c1fe9ad5c084dbb,91-7643432164,13,62,1,63,8,86,94
Taizeen,H,Male,2006-0-15,h@yahoo.in,36bd608ca22f249c1d40688b9d1114be,91-9667468783,18,26,9,35,4,2,6
USAMA,RODDY,Male,03-01-2010,usama_roddy_136@gmail.com,df0992105dddeea064bf3ebb6e76433a,91-7553829675,2,55,11,66,84,7,91
Iha,B,Female,20-07-2011,iha_b@gmail.com,ca124dc638df3945e6cc41ea54e02d74,91-7594227175,8,3,4,7,64,73,137
Raghunath,Prayag,Male,03-02-2009,raghunath_368@gmail.com,8185f85c9cf88c93306206a4e0f0d8a7,91-8812976176,4,9,3,12,99,7,106
Madhur,G,Female,06-10-2007,madhur_783@yahoo.in,db2708bdc265d53a4551a27de5aa5f2b,91-7658382142,97,6,8,14,9,1,10
Gitali,KIYAAN,Female,23-07-2009,kiyaan@gmail.com,e3403056d4e4ceab7d0bc48d7f3ab9d1,91-8853898152,92,42,19,61,53,13,66
Mahalakshmi,Sarfaraz,Female,22-05-2007,mahalakshmi_sarfaraz_125@yahoo.in,1b2d5fd90aab6e0cba7b6079507204fe,91-7413633183,27,2,75,77,3,2,5
Tulasi,RESUL,Female,2009-0-20,tulasi@gmail.com,283994782dc96afef213ffc71d1d5aab,NA,0,0,0,0,0,0,0
Patralekha,A,Female,21-11-2009,patralekha@yahoo.in,2bbd5a2f51f817eba36faf20646cb48b,91-7378975611,75,19,68,87,41,24,65
YUSUF,Balaaditya,Male,24-03-2012,balaaditya_817@yahoo.in,ecf9f7a68c4a99f9f3d776b5f3af3d5d,91-7463312693,13,9,4,13,9,97,106
KORIE,W,Male,20-06-2005,korie_w_613@gmail.com,60c177ebe3541f91b077e829d801dd57,91-8767363151,6,3,91,94,4,96,100
Shyamala,M,Female,2012-0-19,shyamala_m_874@gmail.com,85488f86d8d82e26b27054a78df7712e,91-7611861397,9,2,4,6,15,63,78
PRZEMYSLAW,J,Male,20-03-2008,przemyslaw_j@gmail.com,6c05747ce584ee8a95f5df60cba054f9,91-8779957253,18,49,4,53,1,9,10
CRISTIANO,Kuberchand,Male,30-04-2005,cristiano_kuberchand@gmail.com,64a2c06f4c0f81471d03c10206754ba4,91-7169667346,7,4,96,100,43,93,136
Shantala,U,Female,24-07-2005,shantala_u@gmail.com,e57ccc5714c10c751d485788326cf2c6,NA,0,0,0,0,0,0,0
KANISHK,T,Male,25-11-2013,t_893@gmail.com,23cf7a7354c11d7be8140edd27ddf17f,91-8874689124,7,63,2,65,54,5,59
AMINUL,T,Male,22-05-2008,t@yahoo.in,2056c680ae1d85dda2cef909d254176a,91-7312893168,3,22,3,25,7,51,58
Aratior Aaarti ,Sudhindra,Female,29-04-2008,sudhindra_489@gmail.com,8f5adedaf62c977d095fa78100736fe6,91-7843515892,16,2,1,3,76,1,77
SHAI,Yaduraj,Male,22-11-2013,shai_yaduraj@gmail.com,3d8a51419aa2c392d8f3e1d8eddd268b,91-7164174681,51,72,88,160,3,2,5
Hasna,ASHA,Female,28-06-2008,hasna_342@gmail.com,d4ec2718d82fc0c9a86562fa7d0ac58a,91-7175937244,83,9,91,100,3,86,89
Tilottama,MARTIM,Female,07-10-2012,tilottama_859@gmail.com,6a9fefd6bdbd0c46273df66b136df435,NA,0,0,0,0,0,0,0
Taraka,W,Female,20-09-2011,w@gmail.com,5f0a4096006a274a3674def907985271,91-9722444268,58,2,72,74,2,91,93
Deependra,TANAY,Male,2013-9-31,tanay_642@gmail.com,2476b7bd0eba7245f8cf959dd1fd5ace,91-9315747193,57,5,68,73,14,55,69
Pramada,Q,Female,24-04-2013,q@gmail.com,b3632a3382d7e13f0287ba160c234a0f,91-9674733112,98,78,12,90,8,7,15
Jagmohan,Niteesh,Male,29-06-2008,niteesh@gmail.com,26ad4caa1e943878871fc38847428b6e,91-8739765849,41,75,52,127,8,15,23
Shyamangi,Vikrant,Female,28-09-2005,vikrant@gmail.com,940ddfad7989a8d539c00da4d7621dea,91-7878719494,98,96,9,105,11,78,89
Shrivalli,N,Female,17-10-2014,shrivalli_n_495@yahoo.in,0770dd7b84595f80084f54c0dfcbdc8d,91-8221582763,32,59,65,124,23,24,47
Induleksh,R,Female,20-06-2010,induleksh_r@yahoo.in,07e1d89171c54ef35a5b6427f2185495,NA,0,0,0,0,0,0,0
SAMARTH,X,Male,27-10-2004,x@gmail.com,d2b5c023ae87656d642c6eb1df5cf42b,NA,0,0,0,0,0,0,0
KAYIN,I,Male,15-09-2008,kayin_749@gmail.com,f2a1d2581e11bd4cd636840a3f81fb65,91-9466448477,1,26,38,64,2,22,24
BINYAMEEN,Z,Male,21-04-2004,z_628@yahoo.in,bf4dbeb2b84da1a2bbf914a4735c64c1,NA,0,0,0,0,0,0,0
Lavor Luv ,I,Male,27-10-2013,lavor luv _i@gmail.com,2a066bdf3f0202c1dd762788148e271f,91-8112145682,7,54,61,115,9,8,17
ANTONIO,Y,Male,05-03-2007,y@gmail.com,baf18de59f81d7fa4c9577916cce6c5e,NA,0,0,0,0,0,0,0
Shivani,U,Female,26-11-2013,shivani_u_146@gmail.com,95702aaebaec5a653a10f2c8eec341c9,91-7297344163,2,72,36,108,3,44,47
CRISTIANO,MILEY,Male,13-11-2011,miley_657@gmail.com,99258f54f1b88143c7e43eb7f4d86bd4,91-7392815432,94,65,6,71,54,5,59
Bina,KIEAN,Female,22-11-2007,bina_427@yahoo.in,619d0fc0e1b85657472d8c34589b0058,91-7778413177,5,3,15,18,6,12,18
Rukmini,NEILAS,Female,22-06-2007,rukmini@yahoo.in,e661a9c335f112f56adeb5a2925eeef9,91-7237113542,33,8,14,22,8,21,29
Tapi,V,Female,21-04-2013,tapi_v_234@gmail.com,62cf232a3c9ba3961464304b4c5163bb,91-7657355638,38,3,1,4,8,81,89
SHABIR,Y,Male,28-05-2011,shabir_y_679@yahoo.in,540be8573f52e4c64225d5fc2c39e53a,91-8328668863,95,9,18,27,9,6,15
Chandrabhaga,G,Female,16-09-2010,chandrabhaga_g@gmail.com,d388c97af4a6feefb94c56481ecd444a,91-9174343824,47,7,98,105,8,29,37
Sinsapa,FRASER,Female,05-10-2007,sinsapa_fraser_438@gmail.com,4055a700d15997892680132260ad96be,91-7455987493,58,4,58,62,93,4,97
Sajili,LOUIX,Female,09-07-2014,sajili@gmail.com,c63bf783fb4eb936566007b42db0fad6,91-9936331158,3,8,8,16,9,98,107
TAI,D,Male,09-06-2009,d_594@yahoo.in,be66049f6aa840dad4a187801ca4eae4,91-9321111678,9,3,84,87,97,5,102
DARRYL,SHAYAN,Male,27-04-2006,shayan@yahoo.in,884c51d48c60368f87cb87dc0488fae0,91-7195651985,5,82,8,90,4,25,29
ORHAN,I,Male,05-04-2004,i_518@gmail.com,577985fe070d36363773f47f5de8fb18,91-7684164797,65,3,37,40,23,16,39
Nibodh,A,Male,13-10-2011,a@gmail.com,19eba123da44eca8cd4df0fffb1901ad,91-9894418356,5,8,36,44,8,49,57
Karuna,U,Female,2011-0-12,karuna_847@gmail.com,5f673c1335b75cb643b8f9480e013cb5,NA,0,0,0,0,0,0,0
Japan,M,Male,19-09-2009,japan@gmail.com,21d4f9f031296a3e7190ff0b4394a0f9,91-8768452549,12,3,9,12,6,99,105
Rakshan,D,Male,05-03-2004,rakshan_132@gmail.com,04316adcb72127c57c2c3b82c5580a30,91-7755966852,47,69,57,126,31,6,37
Disha,C,Female,07-11-2013,disha_c_914@gmail.com,4d8f2529372edfa34a9c629a17a8ccc8,91-7969283196,29,35,65,100,7,6,13
SKYE,CONSTANTIN,Male,27-05-2012,skye@gmail.com,0a0cc628c63a96b058f4a4f237aa9274,NA,0,0,0,0,0,0,0
SZYMON,Satyaki,Male,20-04-2009,szymon_satyaki@gmail.com,acea9a08bb706bb9338e453e38165751,91-7325989259,5,74,89,163,12,1,13
SALVADOR,L,Male,28-01-2007,salvador_l_781@yahoo.in,662c51eaeb716dfcaf2d7109e6f9a257,91-7637723881,3,95,5,100,8,38,46
NAZAR,Ekram,Male,13-02-2008,nazar@gmail.com,d92257eb97c493ae0f3134f0a1ab7a7c,91-7367663695,46,9,1,10,6,9,15
VICTORY,AMAAD,Male,22-08-2014,victory_567@gmail.com,40da2c3085e56910be01d5a16d081a3c,91-7359845924,36,84,5,89,56,7,63
RAMIAH,JO,Male,02-04-2010,ramiah_jo@gmail.com,8adf5e2ed2f3df733108d25b20ccc17b,91-7358314922,1,35,32,67,6,83,89
Shivangi,Fanishwar,Female,30-07-2005,shivangi_fanishwar@gmail.com,bbc9f3022d1cc7126c28c8d1f049d969,91-7735519748,25,7,4,11,7,74,81
SHIV,DAVIDE,Male,20-05-2010,shiv_davide_647@gmail.com,67d438c746ada60d11129077f7f13d35,91-7211489577,87,5,4,9,17,3,20
ERON,Jograj,Male,15-09-2005,eron_jograj@gmail.com,98a0bd8bf287f98bc58f412741ba92a2,91-8667553629,2,45,25,70,2,84,86
Sanchali,MUNASHE,Female,19-05-2010,sanchali_munashe_562@gmail.com,b47e2c3a4125decc9512a9d01a41e9e2,91-7178457821,1,58,5,63,6,2,8
JAIVAL,DAVID,Male,28-08-2008,david_542@gmail.com,824168ca4a3210d36c0a99dcb6bb3cc6,91-8259573671,7,9,5,14,7,8,15
KAIDE,MANRAAJ,Male,08-01-2013,kaide_manraaj@gmail.com,3b9acfb9e89de54b4596d6a3a73a67db,NA,0,0,0,0,0,0,0
Alpa,X,Female,2012-0-2,alpa_x@yahoo.in,d947b7912e600002f7d51ab15af0935e,91-8711935548,89,52,3,55,1,5,6
JIN,Chidambaram,Male,02-05-2006,chidambaram_513@gmail.com,9315a8d63e1749bdd01b58d9c771ee71,91-8716617977,3,43,64,107,56,2,58
LU'AY,Sambaran,Male,18-11-2004,lu'ay_sambaran_754@yahoo.in,c2e3f9ec864352dc1041e87b0bc9b4b2,91-9912156382,5,4,1,5,4,64,68
SAMIUL,R,Male,20-06-2012,r@yahoo.in,721ef73a722a54f4357696bc37905466,91-7963693651,37,15,6,21,55,7,62
Angana,Z,Female,20-09-2007,angana@yahoo.in,ffe09926dd0fad57c2b72da9e893ba0f,91-9333826585,9,51,34,85,2,5,7
Shashi,TAMAS,Female,11-03-2008,shashi_873@gmail.com,19118cdcf0257875309b83607888d70c,91-7332732449,54,63,52,115,87,8,95
ASTON,V,Male,06-04-2009,aston_v@gmail.com,cc28aabd56a023f1e49c7b745c04ddb9,91-7656783721,62,97,3,100,4,88,92
Chandran,H,Male,22-04-2013,h@gmail.com,dffa11c1540a16aa03cfbbe8d951f4b6,91-7496692745,2,37,18,55,8,69,77
Kusuma,JEHAD,Female,13-01-2013,kusuma_jehad_716@gmail.com,ddbe6e6d3291748c5701c915478476e6,91-7719371513,9,29,29,58,9,8,17
Lajjawati,G,Female,28-11-2010,lajjawati_g_726@gmail.com,fd22b3f71d160dba1eb5a310941e337d,NA,0,0,0,0,0,0,0
ALEX-JAY,J,Male,30-08-2004,j@gmail.com,3f53b9848c457d7733d947e29772c70f,NA,0,0,0,0,0,0,0
Jaipriya,L,Female,25-05-2005,l_429@gmail.com,1da06a0a85323b0428f4f94dce5da2c8,91-8432787165,33,8,3,11,99,76,175
Madhulika,D,Female,28-03-2009,d_548@gmail.com,3d874add94e372f285bd0ea5def30247,91-8133261191,6,92,1,93,5,92,97
Shravanti,Pransukh,Female,26-01-2011,shravanti@yahoo.in,9da8024238c9e7495df1f7b1a3c5b552,91-8684216142,9,82,8,90,5,7,12
Muhamad,Z,Male,28-11-2013,muhamad@yahoo.in,c0e8d0aed5aa95efc6293cfe7e1298d9,91-9777977855,5,49,82,131,58,8,66
VALENTINE,MAURICE,Male,20-10-2009,valentine_591@gmail.com,4b5b0a4b5fcc279bdecb89ea3f92961a,91-7487269924,7,5,49,54,28,82,110
BOWEN,E,Male,2011-0-23,bowen_e@gmail.com,aac8d6a03fe28ff7dec213f5f9d3d6b7,91-7181878774,49,1,91,92,81,63,144
Selma,SHUJA,Female,2004-0-8,selma_154@gmail.com,925fea92bed8690906c9c592150b317e,91-7556183978,84,51,96,147,51,79,130
Pujita,O,Female,2010-0-9,pujita_o@gmail.com,cd8e4face3bb340927bd62701916ba98,NA,0,0,0,0,0,0,0
MUSTAPHA,ZAC,Male,03-06-2006,mustapha_zac@gmail.com,478a84624c00d9526c0b8b9848456fa4,91-7698367653,32,75,3,78,9,8,17
FINNAN,S,Male,29-05-2011,finnan_s_894@yahoo.in,efa5a81c71f029d6f7dc030366990c3c,91-7837573493,26,93,46,139,1,92,93
BARNES,MAXI,Male,05-10-2012,barnes_856@yahoo.in,e3e70f309ada747b82c3d0dd16c42157,91-7898995574,8,4,6,10,43,4,47
Vedprakash,JAY-JAY,Male,21-10-2007,jay-jay@gmail.com,fbffefa6268d47b3fa915e9ea1ac62b2,91-9638419839,99,27,54,81,23,63,86
Bimal,H,Male,05-08-2009,bimal_h_415@gmail.com,cdc024090f6709035ae3dd0570ef1590,NA,0,0,0,0,0,0,0
Chandraja,EMLYN,Female,06-08-2014,chandraja_emlyn@gmail.com,bc6f1531fddaae44d2a880a7aa93b618,91-8752149392,2,4,1,5,65,7,72
Durjaya,X,Male,28-10-2008,durjaya_943@gmail.com,9d3af0d0e414b1a942c6b4f2ecf6ea3c,NA,0,0,0,0,0,0,0
Rambha,X,Female,19-04-2008,rambha_x@yahoo.in,ac70e51a00af0fb302de6c461a1cac63,91-9181787145,2,7,4,11,55,6,61
Indrasuta,Y,Male,13-03-2007,indrasuta_y@yahoo.in,480d2070888c3dd85991250bcd9768b5,NA,0,0,0,0,0,0,0
Hina,RONNIE,Female,07-03-2007,hina_ronnie@yahoo.in,39666edef05aa7695332d4fb48589f99,91-7227222117,1,6,5,11,5,3,8
Teerth,U,Male,15-09-2007,teerth@gmail.com,414b2c3c793b6f88deeded6c87d124ab,91-7914595241,73,6,9,15,8,2,10
Priyal,TONY,Female,22-05-2007,priyal_tony_258@gmail.com,01f53cc3ee2b1833e8693ee164a76307,91-9174821173,6,1,24,25,84,99,183
Manasvi,ARCHIBOLD,Female,30-10-2014,manasvi_archibold@gmail.com,b99f183a3aaf1bd2b62f779edf605c5b,91-7539921722,99,6,5,11,31,7,38
Ritu,Girik,Female,2010-6-31,ritu_girik@gmail.com,16825a79bee90273dde725c70a6c9633,91-7892139882,54,3,17,20,78,3,81
Vetravati,L,Female,06-09-2005,vetravati_l_931@gmail.com,5917bda7e4edf2d7f151c88c022a3bfa,91-7286726371,9,35,9,44,5,3,8
NEMUEL,JEFFERY,Male,2014-0-21,nemuel_862@gmail.com,ac152e6ccf2b0b75290e83e2cd18d210,NA,0,0,0,0,0,0,0
Shirin,Falgu,Female,14-03-2010,shirin_427@gmail.com,10b56b0e7fb02af2a7a7447df9c7c043,91-9896341978,7,3,8,11,71,4,75
Kanaka,RODNEY,Female,12-10-2005,kanaka@gmail.com,01733b3ec66cb148c26381e7f4b3b630,91-8189282772,86,8,85,93,4,39,43
TANISH,EMAAN,Male,11-05-2013,emaan@gmail.com,d3888cf5ab8b1218cd9a86d56f74a891,91-8554755991,7,5,3,8,39,71,110
Shyamlata,BERNIE,Female,17-06-2006,shyamlata_bernie_714@yahoo.in,ca55f0e7e0a5d8dc5aaa61f91390ce9b,91-8859886628,9,51,9,60,21,7,28
ZUHAIR,G,Male,24-10-2007,g_476@gmail.com,1e40cf4fea9c6942af561a3c18834613,91-8113726395,1,47,54,101,46,3,49
Chandalini,E,Female,09-03-2014,chandalini_e@gmail.com,482036cd49874a47cce5119de700aca1,91-7188658793,8,3,7,10,4,9,13
FAAIZ,P,Male,07-11-2005,p_268@yahoo.in,ea757b274f3e6a4b2b1e91aad0a29314,91-7523728238,3,3,8,11,2,4,6
Jayalakshmi,U,Female,21-03-2005,jayalakshmi_654@gmail.com,91581e899613e4480d8b2ecb70071751,91-7436359549,91,66,3,69,5,2,7
Dayanidhi,A,Male,21-07-2013,a@gmail.com,857e53d893d0732f8dc0eb8f43b406e7,91-7192171337,83,4,1,5,21,8,29
Chandrakala,Sharador Sarat ,Female,29-08-2009,sharador sarat @gmail.com,0a2a30ca77ab6fec79d6343140e3531b,91-9513618876,15,82,64,146,54,28,82
LANDEN,V,Male,13-02-2009,v@gmail.com,02aa3cd060c550503dd8fb89da2317d9,91-9952871975,3,28,4,32,2,75,77
Devahuti,RASHID,Female,2010-0-26,devahuti_rashid_847@gmail.com,b34a07de4812b825497821b14514e676,91-7518534428,3,16,37,53,9,21,30
Chimayi,ELIOT,Female,30-09-2012,chimayi_eliot_426@yahoo.in,3144c999dadf7899aabfa4a50e969fc8,91-7523767826,91,37,9,46,87,84,171
CASPAR,W,Male,2013-0-24,caspar@gmail.com,5661034c58acb774592cc1cb2b505b44,91-7343938293,81,59,9,68,3,7,10
Kuyilsai,O,Female,22-04-2012,kuyilsai_235@yahoo.in,7b0fdb5ed0ffeac56b39f48c11d6e589,91-7976965559,1,5,78,83,16,96,112
Sudhish,V,Male,20-08-2013,v@gmail.com,6d8225641188f0d8e1ec0fb149bd7204,NA,0,0,0,0,0,0,0
SALAHUDDIN,E,Male,24-10-2005,salahuddin_e@gmail.com,1cedfe880d270f6e0c8e1caba8566266,91-8254584773,9,84,9,93,5,4,9
TIEREN,MURRAY,Male,19-06-2014,murray_257@gmail.com,e378b0a75fc58abfe10c496556d5c132,91-7595117387,6,3,7,10,7,1,8
ROLAND,WYSTAN,Male,02-04-2009,roland@gmail.com,a80df7a878af5ad0926c48b907b06f0d,91-7583637382,86,5,8,13,2,2,4
SARIM,D,Male,13-01-2004,sarim_d_163@yahoo.in,644a3588a0721e59ca284985161238a1,91-8158619495,76,38,22,60,7,88,95
Dhuthi,SAMMAN,Female,25-08-2012,dhuthi_135@yahoo.in,86c0d8344ffd38e7e46f4f8622d938db,91-7896494419,3,3,88,91,31,3,34
Neelkamal,Barindra,Female,27-02-2005,neelkamal_barindra@gmail.com,ed1014b30e2ce32316d4024c9f3c7ce8,NA,0,0,0,0,0,0,0
BENOIT,MARTIN,Male,01-05-2007,benoit_martin_283@gmail.com,e2186dbbd7586647ba90b039c8e2b261,91-8933257129,7,84,6,90,8,58,66
Rashmika,R,Female,26-10-2013,rashmika_r_423@gmail.com,7cd36917fd15ecd44e3c7e2f4a751dc6,91-7684786251,8,18,59,77,63,71,134
LAYTON-LEE,J,Male,14-03-2004,j@gmail.com,1933e18e71b251df12eaefcd911b662b,91-7735297512,68,6,9,15,65,5,70
FARHAN,CHUKWUDI,Male,2011-6-31,farhan_chukwudi_534@gmail.com,757df6291343799c9fb5805e592a362f,91-9829846168,4,57,15,72,1,6,7
Madhavilata,B,Female,27-06-2013,madhavilata_b_795@gmail.com,6e9a7c5730114887dc2b1857d7d3a325,91-7821754339,7,6,9,15,46,9,55
Harish,V,Male,23-04-2007,v@gmail.com,a799f2c376f3dcb8de8d89142e7f50d8,91-9862415138,66,17,29,46,7,5,12
Parvati,H,Female,09-01-2008,parvati_h_419@gmail.com,843b41a9998679c8282bbebb01042720,91-8267253353,82,69,59,128,68,4,72
ILYAZ,Asgar,Male,03-11-2005,asgar@gmail.com,973c784f3bef68c20ffba8cf3e06c9e1,NA,0,0,0,0,0,0,0
MALIK,LYAM,Male,13-01-2008,malik@gmail.com,d77e804cd4703ceaafd6def91b6d771a,91-8532819439,57,9,72,81,86,8,94
SOHAM,V,Male,2013-0-3,soham_v@gmail.com,395c19ccacc48b9a6deaeea92f056979,91-8324466175,5,32,63,95,3,1,4
ROMAIN,P,Male,29-09-2010,romain_p_279@gmail.com,8a25770cf2a9eeca16b064b682be474d,91-7826162138,1,7,22,29,6,78,84
Archana,A,Female,16-03-2004,archana_129@gmail.com,d461d16113bc0efdb4ce7941fd04f698,91-9415331298,71,94,9,103,1,27,28
Buddhadeva,T,Male,28-07-2006,t@gmail.com,ee58ed19af50032b88bad12a4608dc19,91-9554329568,6,7,6,13,68,5,73
Kishori,W,Female,25-10-2011,w@gmail.com,bc32e404820cc8440a903162718cacea,91-7457355948,7,3,39,42,7,24,31
Ekachith,MORLEY,Male,24-08-2009,ekachith_morley@gmail.com,ce0aa80f837b33f39c67fa454966c1ac,91-8141924653,34,96,44,140,17,15,32
ALEXZANDER,P,Male,22-03-2009,p@gmail.com,237bf79d9da9223145aa41440a22a886,91-7228478898,89,5,6,11,91,9,100
ABDUS,K,Male,2007-2-31,abdus_k@yahoo.in,1ed385c14897cd92cfcd26d1a9154801,91-7219518628,43,93,2,95,95,54,149
MICHAL,I,Male,29-07-2012,i_218@gmail.com,eaaff4695093cb2f8e6592a64e966bf9,NA,0,0,0,0,0,0,0
ALEXAVIER,MIKS,Male,26-11-2014,alexavier_miks@gmail.com,2926e9fc4652cc5958b0858670ca80dd,91-8624178989,7,9,62,71,21,5,26
Ratnabali,F,Female,2013-2-30,ratnabali_f@gmail.com,3c7475f9d7110c08670f78fc6d1e7203,91-7566178493,46,55,22,77,5,26,31
ZACHARIYA,H,Male,23-06-2013,h@gmail.com,b21bc2c8884f76e0b582407aed1401a9,91-8768629472,2,3,4,7,34,28,62
Toral,R,Female,14-03-2009,r_289@gmail.com,ec3952564b4a3bdfc235113bf48ccc88,91-7612353993,73,46,9,55,43,3,46
Ulagappan,LAKHAI,Male,09-02-2005,ulagappan_lakhai@gmail.com,bd1f3553a66cbccde4b19840bbacb367,91-8468423937,83,3,2,5,3,94,97
Gajalakshmi,ATUL,Female,04-06-2006,atul_637@yahoo.in,6fea32b2225d62db5e83a63df23d9926,91-9818363549,37,4,6,10,3,2,5
Piki,ALPHONS,Female,29-09-2004,alphons@gmail.com,7fedca11c740ba5511749afddd6373ed,91-9175854176,6,52,5,57,93,1,94
Prakat,R,Male,18-09-2009,prakat_r_187@gmail.com,019ca23be73fb1301bd4b6dc3583ed57,91-7183768726,4,94,4,98,5,4,9
DAKSH,ABU-BAKR,Male,13-02-2004,daksh_abu-bakr@gmail.com,77ba266d3cd3dcc324c55a4d6296c3fd,91-8762842667,58,6,6,12,4,2,6
GIORGI,H,Male,02-01-2006,giorgi@gmail.com,1e4376bbf5cddf7c591275e72104b6a6,91-7669854451,39,37,6,43,4,27,31
KAEDYN,O,Male,02-08-2007,kaedyn_645@gmail.com,87b4582780982976fc3f702e86140885,91-9572619871,7,6,6,12,7,5,12
OTHMAN,U,Male,26-02-2007,othman@yahoo.in,e1d6704721db6db67fa1adf351953913,91-8245562975,1,79,2,81,23,6,29
Janya,ZIDAAN,Female,23-06-2011,janya_zidaan@gmail.com,15f3ac092ae80fc60effc1940017498b,NA,0,0,0,0,0,0,0
VALENTINO,T,Male,05-09-2013,valentino_t_651@yahoo.in,b743fbfb77598d992180246514f3bd01,91-8681459255,74,83,66,149,84,51,135
TUAN,M,Male,21-01-2005,tuan@gmail.com,6f147ee94ddae430eebf06ed1b551681,91-8673854265,4,8,7,15,59,68,127
MUSA,RAKIM,Male,24-09-2011,rakim@yahoo.in,fb0d27807f267e5443d20eda6a6a89bb,91-7594755155,6,95,55,150,9,84,93
Muktananda,MAHAMED,Male,08-10-2005,muktananda_mahamed@gmail.com,faef0ed311b4d5fcead484e4b2c0237f,91-8596216388,58,88,24,112,39,9,48
Sudhamayi,ANIQ,Female,2014-0-25,sudhamayi@gmail.com,4b3a3fb5633fa86bbabc488c20ba3c23,91-8452784954,95,29,95,124,51,4,55
Yamya,HEZEKIAH,Female,20-07-2012,yamya_hezekiah@gmail.com,4f8a028d0600b14264a9309de570d135,91-8635938359,4,9,1,10,3,5,8
Vinata,BRENDAN,Female,22-06-2012,brendan_284@gmail.com,6e50953540749449d5b2fde52ed4e6da,91-8263164836,6,28,64,92,37,39,76
BARIS,LUC,Male,04-10-2006,luc_459@yahoo.in,038820919529bf984b8ce25658327cff,91-8628484712,45,94,87,181,6,5,11
Nayantara,Z,Female,12-04-2008,nayantara_z_136@gmail.com,f3e6049638d3b90232d529b4a430e942,91-9892787956,88,24,2,26,7,8,15
IBRAAHEEM,Gopal,Male,20-05-2014,gopal_213@yahoo.in,45dc47d3ff8360139883d1ebb61cb2bc,91-9587235726,38,7,35,42,8,21,29
Hiresh,DHEVAN,Male,31-07-2011,hiresh_dhevan@yahoo.in,fd7564b677af1ac4c1cec96727bbbc88,91-7941181937,8,8,79,87,91,5,96
Omprakash,PARTH,Male,02-03-2014,omprakash_458@gmail.com,3cbedcb2a2963af4d789415df21ffdff,91-7273335566,35,31,9,40,42,4,46
IHSAN,RAYON,Male,27-05-2005,rayon@gmail.com,e11f661e9a5cf2e31b75931e929b9572,91-7658517372,49,3,54,57,28,2,30
Sujaya,W,Female,18-02-2009,sujaya_735@gmail.com,8ca6ae0df4f5a366bff38ee8cc4da316,91-8379574344,9,3,3,6,7,3,10
Manisha,RAUL,Female,23-04-2009,manisha_raul@yahoo.in,9f887b31714bc53affe85b3bf366532c,91-8338233845,4,6,1,7,4,21,25
Vilasini,ELAN,Female,10-06-2013,vilasini_elan_496@yahoo.in,7db4bbd6d3266996d5af36776ad3e470,91-7596451391,1,5,7,12,7,47,54
Ariktha,Ehimay,Female,24-09-2008,ariktha_ehimay@gmail.com,677b33158e17be9ea4acf3b015c95eb2,91-7455361291,4,91,5,96,7,93,100
Hemanga,Smritiman,Male,12-02-2005,smritiman@gmail.com,6e694d062399341945e6a350ac5aae18,91-7688481519,91,75,29,104,7,3,10
Pia,Z,Female,16-03-2005,z@gmail.com,deda25dc5de094eba1d9ab899525f816,NA,0,0,0,0,0,0,0
ABDIASIS,O,Male,07-11-2007,abdiasis_o_278@yahoo.in,2071333cffa94505aad590fa931bb951,91-7311764667,53,86,3,89,76,13,89
AMARE,JOHN-PAUL,Male,20-08-2011,john-paul_537@yahoo.in,1d31f87fbfa9c9b30034416d5ee7f0af,91-8579492734,57,8,65,73,31,26,57
Chitrani,BARNEY,Female,09-08-2007,chitrani_barney@gmail.com,13bbc87749a5ab6a754e470f4e4c6478,91-7952149148,3,99,33,132,4,96,100
KELTON,Sanabhi,Male,29-11-2010,sanabhi_915@yahoo.in,86c3fc30a82ec0ab3e1a0c81b8ec45fb,91-9799839137,91,69,7,76,2,69,71
ALAND,W,Male,06-10-2007,aland_w_147@gmail.com,75fb15c2d2f1ec4d77a9218d45811cf6,91-8787121786,3,48,73,121,94,94,188
Ishrat,W,Female,11-09-2005,w_851@gmail.com,9a014d7e052f088f0212a466c235a7f9,91-8796314696,2,5,12,17,4,2,6
Gunjita,CADEN,Female,17-08-2009,caden_648@gmail.com,1d6f90a95a05ee1413c2550531eca076,91-7868893444,2,97,9,106,7,24,31
RAID,T,Male,10-11-2013,raid_t@gmail.com,48b0ef5b3af3e7711f1d12e4f29f755d,91-8982469484,6,7,8,15,12,7,19
CAELUM,SACHIN,Male,2011-0-13,caelum_sachin@gmail.com,303e4953e10f54517570355751e078ad,NA,0,0,0,0,0,0,0
Mangai,N,Female,12-02-2011,mangai_n_654@gmail.com,44024af99df9c60c68bd533d1a1ae9ff,NA,0,0,0,0,0,0,0
Manana,JACKIE,Female,06-05-2013,manana_893@gmail.com,081079fe6dec7861b7de4e46f30d982c,91-9575388513,4,4,4,8,9,57,66
Savarna,N,Female,19-08-2013,savarna_n@gmail.com,84fdd7d9bda37cb84f8c02b72954dc0b,NA,0,0,0,0,0,0,0
Sameena,ISSA,Female,26-03-2014,sameena_issa@gmail.com,c6bce750d3d4280d84c06861cda86ba1,91-8454436546,43,4,22,26,2,1,3
ROHAAN,Jaisukh,Male,06-03-2011,rohaan_jaisukh_915@gmail.com,3de50cfb5294c6501465c72737a3c645,NA,0,0,0,0,0,0,0
Manorama,Utkarsha,Female,25-07-2009,manorama_utkarsha_794@gmail.com,925a2d23b679b0fd2724bed83e1605fd,91-7146431876,18,9,38,47,69,18,87
Megh,TZVI,Male,23-10-2009,megh_tzvi@gmail.com,b3bb2235c32b5114733c422de85b2ba6,91-7871531237,9,4,24,28,3,2,5
TAMARI,B,Male,2012-0-3,tamari_b@gmail.com,f34303de7d23cef1692871202ccdc66c,91-8751557163,95,71,29,100,1,92,93
Ratnalekha,JAYDEEP,Female,25-10-2005,ratnalekha_jaydeep@yahoo.in,df106be0027f4b210673e60b325a70a0,91-7851461227,87,53,6,59,66,2,68
NILE,Thangamani,Male,19-10-2009,nile_thangamani_152@gmail.com,9559373ca89a3ba8a72a186b748a2702,91-9169237816,2,23,94,117,51,18,69
Ganapati,G,Male,30-06-2008,ganapati_g_172@gmail.com,28cb732dc0894e80afb60b3437311222,91-9874167115,5,41,63,104,58,78,136
Shrigeeta,JUSTAS,Female,29-09-2009,shrigeeta_justas_753@yahoo.in,7fcfb79293d315e5f06c136f40a11de1,91-7272859164,93,91,1,92,18,5,23
YANNIS,J,Male,18-06-2006,yannis_j_379@gmail.com,8d9ff104a5801e2b945b4792d40c980b,91-8656527134,64,6,7,13,4,92,96
YUAN,K,Male,22-10-2006,yuan_k_764@gmail.com,2d13b5859f16d1aeb8511fe275046773,91-7115322536,91,31,25,56,6,1,7
JAIDEN,HADEN,Male,2006-0-8,jaiden@gmail.com,d937ec37786053b0f73aefe06fc5ac39,91-7649672453,5,3,7,10,56,81,137
Dheivamani,DEMETRI,Male,04-04-2013,dheivamani_demetri@gmail.com,66fd08924d9d433c14bae8b6b9f6fa6d,NA,0,0,0,0,0,0,0
ERNEST,JADON,Male,24-10-2005,ernest_483@gmail.com,01fe2322c7c5430b851c3cc7d78045af,91-7259143113,21,89,92,181,15,2,17
CIRO,J,Male,09-09-2010,ciro_j@yahoo.in,6e1cda3251368c47982a148c00211115,91-7324152674,21,21,5,26,16,27,43
HARKARAN,FERGUS,Male,21-11-2014,harkaran@gmail.com,640faf01ab1f8a078f6a1b7a5d95d819,NA,0,0,0,0,0,0,0
Priyamvada,PHILIP,Female,2013-0-15,priyamvada_philip_291@gmail.com,0a53f90b3ad5b2d382bff3e2bd21a081,91-8549186626,98,6,17,23,7,9,16
Chandani,Nirmit,Female,23-04-2013,chandani_nirmit@gmail.com,20696187eb33007aee10aa2eca62e643,91-7241627787,4,9,5,14,5,6,11
Kunjal,O,Female,16-11-2007,o_251@yahoo.in,257ad4131c49dab5cb54211560fffcdf,91-8667874585,2,13,8,21,4,6,10
HENRIJS,T,Male,27-08-2010,t@yahoo.in,1ad620402612ea2963783d3b9a86430b,91-9576858916,74,93,6,99,14,1,15
Manavi,BAILEY-JAMES,Female,03-08-2013,bailey-james@gmail.com,3ecb7a3359357b5d1490bf9902be2bf2,91-7323224744,9,8,3,11,5,89,94
Shabana,L,Female,27-03-2011,shabana_l_591@yahoo.in,2ec28526ebabeac30a43e31ceaf2bc07,91-9918966632,85,29,9,38,62,1,63
RAFFAELE,Y,Male,01-09-2008,raffaele_y@yahoo.in,1028d1f31f9c16fadd6ff2a7e9da56b3,NA,0,0,0,0,0,0,0
ASHVEER,Ritvik,Male,2013-0-2,ashveer_ritvik_239@gmail.com,955f165cb93291bb930b77b6454faf74,91-9592239693,94,49,3,52,4,23,27
Sadhana,D,Female,30-04-2013,sadhana_d_496@yahoo.in,1d2cee3727756034253340a11030f59a,91-9487844716,52,8,87,95,89,2,91
Kuyilsai,Pariket,Female,25-11-2004,pariket@gmail.com,41a4cdc88cb1d12421dd39a4dabce17c,91-7666381298,54,85,9,94,89,81,170
Charita,RAHIB,Female,26-01-2012,charita@gmail.com,0bcc22d52966cde98d598d8b61338b0f,91-8483524584,84,6,3,9,6,16,22
Thenral,Y,Female,21-10-2008,y@gmail.com,f21b6949f61a1607380fdd1a8d608ae2,91-7945276729,23,83,1,84,99,77,176
Samidha,KENNEDY,Female,25-10-2008,samidha_kennedy@gmail.com,914bf9600d243c8b5d5b7672de681a8b,NA,0,0,0,0,0,0,0
Juhi,Mrigesh,Female,16-04-2008,mrigesh@gmail.com,aeea2b0a5f8591f88f6f41300f1665f3,91-7184257998,2,62,63,125,5,55,60
TAPIWA,Fadi,Male,15-02-2007,tapiwa_fadi@gmail.com,67a8fc5436f9a686ccf76f1389d1fb66,91-7199522793,2,3,27,30,26,35,61
Triya,RIVER,Female,15-11-2009,triya_river@gmail.com,853549ca5fb20467d29270e33a1ad7d2,91-7582397213,88,95,4,99,68,5,73
CALLAN,C,Male,10-05-2012,callan_c@gmail.com,affa7e2abe53d2ebfdb144597fc6c4b5,91-7782655369,1,9,34,43,57,29,86
Vasu,Rushil,Male,17-01-2008,vasu_rushil_173@gmail.com,3d1275eb72fab758662c994df488b681,91-7648437611,72,86,36,122,68,8,76
Hans,KAYDEN-JAY,Male,2011-0-24,hans_kayden-jay_241@gmail.com,c1e95adec6dd6f6d078a78ab69f71326,91-8977982239,1,97,4,101,8,2,10
Wamika,N,Female,01-11-2010,wamika_n_861@gmail.com,baec9996721926e68e155fadcfbe362d,91-7623837928,7,74,9,83,99,3,102
Mudra,TEDDY-JAMES,Female,02-08-2013,mudra_teddy-james_761@gmail.com,19b4bfa7414cd14f25b4ba49b7fa75f8,91-8719599493,89,1,3,4,3,8,11
Sudipti,Y,Female,19-10-2010,sudipti_y_162@gmail.com,c7f133f1ca567e0829b23845aa4cfe4c,91-9381546139,9,5,6,11,3,59,62
Ratnaprabha,SUDAIS,Female,20-06-2011,sudais_421@gmail.com,82c2537d402fc965665ccb914d7749d9,91-8411949246,7,79,79,158,46,39,85
Kusumita,AIDYN,Female,25-04-2011,aidyn_467@gmail.com,938cb2a8f030d402d9d46de1b01b5291,91-9473952436,76,4,66,70,29,84,113
Pramiti,FREDDI,Female,07-07-2011,pramiti_685@gmail.com,63e76c99eb6910ba3750ab474e38a8fb,91-7421342775,1,6,2,8,9,34,43
Ishrat,HASNAT,Female,22-02-2010,ishrat_hasnat_976@gmail.com,8a8c1cea2806e6aec089a8838e1e1def,91-7637669698,7,9,4,13,5,37,42
Uttara,W,Female,11-10-2009,w_715@gmail.com,c25f1097f15cc3bc76eec4473f8b2e59,91-9648265684,24,15,4,19,52,7,59
Maina,B,Female,25-11-2012,maina_b@yahoo.in,9eac842c75b8482dccf2db0393b52a29,91-7322874345,93,5,8,13,93,8,101
Aslesha,D,Female,08-10-2009,aslesha_d_469@gmail.com,8aef807d5b8f6caa87ca03b0ee11097b,91-9986117678,8,53,58,111,5,1,6
TAWANA,TOBEY,Male,17-09-2011,tawana@gmail.com,729827511c272d96ff41cb3a255b3223,91-9615468775,28,8,96,104,4,7,11
Jyotika,ORRIN,Female,04-08-2004,jyotika@gmail.com,4cee9e44c3edf7be98ad6012740ed0fa,91-7989845734,71,16,2,18,98,7,105
Geeti,SAMMI,Female,19-04-2013,geeti_sammi_725@gmail.com,dbdd68012c80767bd0c6ca3d4af58940,91-7816313484,1,7,6,13,3,5,8
Devaki,N,Female,11-05-2013,devaki_149@gmail.com,25d3b7119ba5d4c09f6592f340cb068c,91-7145359253,6,32,19,51,1,4,5
ALFIE-JOHN,V,Male,08-05-2011,v_579@gmail.com,3b489a4a127b1a398b20b0ed66dbe3d3,91-9182544192,26,7,9,16,26,27,53
OSHER,G,Male,06-11-2008,g@gmail.com,b4e6b05d5c733270c7df7aea5f01874a,91-9876347321,64,7,5,12,96,87,183
Urvi,Cheliyan,Female,09-05-2004,urvi_893@yahoo.in,5ecacee01206e868c5a417b98d309d25,91-7566227968,2,4,6,10,8,82,90
YONAH,U,Male,14-05-2006,u_149@yahoo.in,b25f8e5cf34cb462713e2a2e51936694,NA,0,0,0,0,0,0,0
Jasodhara,KALEB,Female,12-02-2007,kaleb@gmail.com,e02cef543270071e8c95203c33ae3021,91-7282491647,8,96,2,98,7,7,14
Upasana,T,Female,16-10-2013,upasana_t@gmail.com,d5b2e8230151c61e83c407a65e4fdb62,91-7521888299,43,9,91,100,2,63,65
Akshit,TIRTH,Male,30-03-2011,akshit_tirth_639@gmail.com,de89958c4869a2fb1538738312208b18,91-7923546488,1,85,34,119,79,6,85
Tapi,T,Female,05-05-2007,tapi_t@yahoo.in,756a3afb72e832b5cf4d264549b62054,91-7594776163,7,53,32,85,5,43,48
Sanjushree,COLM,Female,15-08-2013,sanjushree_colm_512@gmail.com,4138244bb5fb01a5f66ee0cf1a19d87b,91-9875883681,48,69,37,106,2,6,8
Samidha,D,Female,15-03-2008,d_684@yahoo.in,190a68e9bbe14b6d2c933653ff9ced3f,91-7599982744,6,4,91,95,38,9,47
PRANEEL,YASER,Male,11-02-2011,praneel_yaser_562@gmail.com,a4f6e4394c13911c6875e4f591d5069e,91-7738565395,1,34,12,46,6,93,99
STAN,BASHIR,Male,03-05-2013,bashir_724@gmail.com,5773e9589e21f6f6bfe46a1a11db8030,91-7423234391,14,7,78,85,98,73,171
RHUN,Rohit,Male,06-04-2013,rhun_rohit@gmail.com,0b7853e7adc4eb3a3ad689a307d5da23,91-7812976968,27,6,9,15,68,59,127
FYNNLEY,J,Male,19-10-2008,fynnley_j_846@gmail.com,985e0915bcce7267bf2354e6eecdc0de,91-7376435938,2,1,4,5,32,2,34
Agharna,Turanyu,Male,26-11-2010,agharna_turanyu@yahoo.in,059345854f783a1aa2cf783cbf2c98e4,91-7573878261,38,51,1,52,42,79,121
ZAHID,L,Male,24-10-2013,zahid@gmail.com,071a417fe92136d4f921d46a1d6e6f00,91-7177854624,48,6,1,7,77,7,84
TEEGAN,FRANKI,Male,12-11-2013,franki@yahoo.in,d8a3766a6a134f3bbc863ee8337ae853,91-8136242221,2,4,15,19,49,49,98
Samarendu,CORDEN,Male,08-04-2006,corden_286@gmail.com,e479261c253fa7f06a3e1e4589c8ed64,NA,0,0,0,0,0,0,0
MOSES,ABDURRAHMAAN,Male,2011-4-31,abdurrahmaan@gmail.com,42552a455c707e1934430baebe0bf4e0,91-9291228358,7,4,3,7,21,5,26
Mudra,U,Female,26-11-2014,mudra_u@gmail.com,437e9a563795d472c1a1cf68683323f0,91-8386612893,2,35,42,77,5,8,13
Aksithi,J,Female,22-02-2011,aksithi@gmail.com,301c9e005a60f989623a76f1deb0c096,91-7711962572,57,8,4,12,6,54,60
Tamasa,AZHAR,Female,01-06-2007,tamasa_azhar_172@gmail.com,183c3c2819853ef294409b7436890f7a,91-9785691828,8,7,7,14,2,9,11
Trinetra,C,Female,2013-0-19,trinetra@yahoo.in,16faa28faf770acabaa445e92df82912,91-9511623569,4,54,41,95,6,2,8
Trishala,DAVID,Female,22-09-2007,trishala_david_461@gmail.com,71a25ab214c6b87a2eab154b4b048884,91-9392374393,51,1,2,3,17,6,23
Sadguna,E,Female,2009-0-3,sadguna_e_694@gmail.com,d0b4cc22bd6eea46450eb6e4e8036a1e,91-9455289455,34,8,52,60,83,94,177
Jahnavi,W,Female,02-06-2013,jahnavi_w_697@gmail.com,24596a3fb8108c9cc66005130134a536,91-7642765911,54,8,11,19,32,8,40
Balaraj,JOHN-HENRY,Male,09-02-2013,balaraj_john-henry@yahoo.in,a58ff5cf5554bb8a9267c145b6dfd5ec,91-7299112349,41,63,78,141,17,9,26
Sadhvi,Q,Female,05-10-2012,sadhvi_q@gmail.com,2dd0ee21e4a094c05ac83a7a6a5f9444,91-7691895572,18,7,46,53,57,9,66
Chitralekha,Kalash,Female,2008-0-15,kalash_527@gmail.com,f95eaf9a8d3246034d784114b19871cb,91-8899637485,3,78,93,171,62,88,150
RAUF,Sohil,Male,19-02-2014,sohil@gmail.com,80e40009b968f82b2f618de549a9f7ac,91-9331941813,87,34,34,68,5,28,33
Vennela,Bankim,Female,27-10-2004,vennela@yahoo.in,47e6d3f838d8986ba2d2a6e6134d2d8f,91-7622694371,9,5,9,14,68,84,152
Akshan,Abhinanda,Male,01-07-2004,abhinanda@yahoo.in,89830de1ba360f34c7fd2979e8044cbb,91-7761758412,3,3,17,20,5,86,91
Somatra,W,Female,25-10-2007,w_789@gmail.com,ea8a14be4e4d3f8df65cef0315249fa6,91-7898812156,9,13,26,39,22,16,38
JAMIEL,X,Male,20-11-2014,jamiel_x@gmail.com,a0a740003497cab042c7631b519eb357,91-9733543676,34,63,98,161,8,59,67
Madhuchhanda,B,Female,20-05-2012,madhuchhanda_b@gmail.com,3d4e5d35e281fa70c5d0441383f61a70,NA,0,0,0,0,0,0,0
MONTI,B,Male,09-10-2011,monti_b_317@gmail.com,1f63e8b4eaa634191b24b7d969a039e7,91-8531998266,4,29,5,34,7,45,52
JUEL,F,Male,18-03-2013,juel_f_471@gmail.com,fd52008200f471f818f07d68d8b173db,91-7223929395,9,97,5,102,66,22,88
LAWY,GEORGE,Male,22-05-2013,lawy_george_715@gmail.com,230c81c8d221f224d08b7e69ad8d8c6e,91-8879892557,41,95,88,183,56,17,73
Balakumar,Kunja,Male,27-11-2010,kunja@gmail.com,4254cf80facafe6b12adcc198022421a,91-7738818749,48,2,48,50,6,54,60
NOBLE,G,Male,15-08-2011,noble_g_251@gmail.com,f337ca73b34c060b48327b1edac43b92,91-9794358197,4,8,96,104,69,12,81
Dakshina,D,Male,21-09-2007,dakshina_d@gmail.com,5557d89d00a08b7fe8f00fb89f992f51,91-7857616558,4,24,3,27,71,18,89
Nilasha,RILEY-JACK,Female,20-06-2011,nilasha_673@gmail.com,b914c111b87462c9f0292489272f87fe,91-7398244676,99,86,6,92,81,55,136
Urmi,VIBHAV,Female,24-11-2012,vibhav@yahoo.in,d33d410bb514e9224334482f30d95019,91-7424168555,19,4,55,59,5,17,22
KORIE,Sahib,Male,16-07-2008,korie@gmail.com,3ad3986b699c339ad5d106b510e0f863,91-7958234938,4,9,7,16,9,6,15
MAXIM,WOJTEK,Male,25-09-2009,maxim_427@gmail.com,419f0ae2d38b55b02d5d9df041aa58d6,NA,0,0,0,0,0,0,0
Urvashi,SAMMY,Female,19-11-2012,urvashi@gmail.com,3c857f639c1975079b162918bd292b3d,91-9124336889,29,5,6,11,37,43,80
Parvati,HARRY-JAMES,Female,18-03-2011,parvati_harry-james_957@gmail.com,ced48a52d691ce4bed211db86ea0d6b3,91-7738798154,1,18,21,39,97,2,99
Chandraki,H,Female,25-05-2009,chandraki@yahoo.in,f63be0c9f4f4ac056c73406f1c09da09,91-7961459218,48,66,9,75,5,6,11
LEVI,Niranjan,Male,05-03-2008,niranjan@gmail.com,cc433a7615a9db29e25c4bdf1d6a20b6,91-7735177849,49,2,13,15,47,31,78
REX,N,Male,04-07-2004,rex_594@gmail.com,27a75bbdd55d035f327f1c6eb5c221b8,91-7627627245,1,36,4,40,43,9,52
Ihit,NIRAV,Male,13-05-2009,ihit_451@gmail.com,395fcaf3493c064dac95f3ec0d88d032,91-9496141887,7,65,5,70,8,43,51
Priyabrata,U,Male,26-06-2008,u_572@gmail.com,915dbc454106081310e53bf65bfd9bdb,91-7241422324,61,81,51,132,93,9,102
Sanjukta,Prajesh,Female,21-03-2014,sanjukta_prajesh@yahoo.in,d0c816d32cfa00d5fb1668d7527adec0,91-8847948737,7,97,1,98,4,6,10
Chumban,ISAC,Female,29-05-2009,isac@gmail.com,923278bfc2c958e816600c8d3d645cf1,91-9264582331,16,81,71,152,6,42,48
Kundini,Arnav,Female,27-05-2014,kundini_arnav_267@gmail.com,5f0c669ae880f74d65e8663ad8b22a6d,91-9377974579,71,17,2,19,2,4,6
SHAN,Q,Male,30-05-2007,shan_q_534@yahoo.in,e5f9774f471fd4d02dc29a9ce349dccf,91-7921627133,5,86,22,108,38,9,47
FRAZIER,OSSIE,Male,11-02-2006,frazier_ossie_943@gmail.com,788873560ff5cad6991fecd12503c3c2,91-7162412623,5,69,53,122,8,5,13
Jagadamba,EYOB,Female,13-10-2008,jagadamba_eyob@gmail.com,ef337448e19f1dfc6575678ea7574b12,91-7818183188,59,3,27,30,35,42,77
Surekha,C,Female,25-08-2005,surekha_963@yahoo.in,40b4ee6c6969253ab3f8b084f787d388,91-7259798833,7,6,72,78,91,9,100
Ekantha,M,Female,28-10-2005,ekantha@gmail.com,60eab1a38ea0f668c535c049d9f49033,NA,0,0,0,0,0,0,0
Kalya,V,Male,16-10-2014,kalya_v@gmail.com,edbb259a3412caadf91ac9f99e9472fd,91-9975463342,8,53,91,144,87,4,91
Pyaremohan,Smritiman,Male,17-10-2008,pyaremohan_smritiman@gmail.com,c5b31a730bf6b64bbe31d0881d6eda74,91-9664758266,24,7,4,11,81,6,87
Durga,ESHAAN,Female,07-02-2007,durga_eshaan_618@gmail.com,cf87def3d65b1fedbd909df92fcc3e6a,91-8962365816,5,75,8,83,95,23,118
ARIZ,Chetan,Male,08-03-2013,chetan@gmail.com,1a6f538b1a706fb9de165620f16f7743,91-7571222744,7,7,7,14,5,67,72
Suchira,KAIZEN,Female,14-01-2007,kaizen_786@gmail.com,2e68fc26279adf76a3a66068399dd9df,91-7866989125,9,17,91,108,91,6,97
Vasundhara,M,Female,15-08-2006,m@gmail.com,3aa36c09a34d5bdeb66e66ce8871696f,91-7111916265,69,4,6,10,78,9,87
Jaspal,Pratul,Male,04-04-2007,jaspal_pratul@gmail.com,23a065c4c622313fca1d5d0c9219e3c4,91-7497145748,9,4,97,101,1,6,7
SAYEED,KRISTERS,Male,10-01-2007,kristers_361@yahoo.in,9e78f064f758e6476e94edd0e4bf9b30,91-7885747253,59,45,71,116,81,62,143
Hariom,C,Male,25-01-2010,c@gmail.com,ed39b180a13a09ee92a99a7d12622b39,91-7891489996,24,5,2,7,77,7,84
Sanjula,VINICIUS,Female,29-05-2010,sanjula_326@gmail.com,eac1db3a98947305298adaee99a0be79,91-9171334259,69,49,3,52,55,14,69
KARTER,Jayad,Male,17-09-2012,karter@gmail.com,889a40abb7c47f6af57ebaf4aa73a2f1,91-9398449226,1,3,5,8,42,5,47
Gunjita,SZYMON,Female,06-07-2013,gunjita_461@yahoo.in,f1e33386a0ac17dc2a6aed8603b49eee,NA,0,0,0,0,0,0,0
TANIM,NOOH,Male,08-02-2010,tanim_nooh@gmail.com,1d291b0193a03b075c6dac1da25ceca6,91-9896383628,14,49,1,50,1,83,84
Anandita,Chellamuthu,Female,14-11-2013,anandita_chellamuthu@yahoo.in,faa8b47e4be37e3935b6c0beb0aa99f4,91-7514977169,47,59,4,63,19,59,78
Maina,D,Female,17-09-2008,maina@gmail.com,e8a1384b42cc3fab450101b9fc724648,91-7545997224,8,49,78,127,39,87,126
Govindi,U,Female,2011-2-29,u_762@gmail.com,29d28e214391e0eb5f3b23b0b094b806,NA,0,0,0,0,0,0,0
Dilshad,EDDY,Female,09-03-2004,dilshad_278@gmail.com,638224de56de36eac8e30ba83dbc969e,91-7125716278,4,8,52,60,88,21,109
Nirupama,ADONAI,Female,18-09-2013,nirupama@gmail.com,a7d3e56a3e262a0134e929c9f0f76c73,NA,0,0,0,0,0,0,0
Karabi,R,Female,05-07-2007,r_843@gmail.com,854ae66a07529ee9a4ed577b998788a2,91-7491892367,88,44,3,47,39,2,41
Jayaprada,T,Female,01-01-2008,t@gmail.com,c8de5b399a1053ac6ca9c31e4b8995d2,91-9921754626,21,2,18,20,13,6,19
Deeptikana,W,Female,11-04-2007,deeptikana_w_625@gmail.com,ac39224328baacfb4e8587158fb98254,91-8281862192,54,8,3,11,52,7,59
MARLEY-JAMES,B,Male,13-03-2005,marley-james_b_786@gmail.com,f67366d9d237eeb614cf0bb7f1b731e1,91-7118425658,6,7,1,8,1,7,8
Manishaor Mohisha,W,Female,06-05-2012,manishaor mohisha@gmail.com,490f576779bc8a8e80e64fc00784e4e3,91-9974942911,13,1,3,4,1,3,4
HAMAS,SAFI,Male,18-09-2006,hamas_safi_259@yahoo.in,b1719793ce46fbcbcdff4e5f137807cd,NA,0,0,0,0,0,0,0
Avadhesh,G,Male,27-05-2011,avadhesh_483@yahoo.in,9bacfb6b60c257bcbd53304902cf6d24,91-9356794518,47,14,4,18,5,54,59
Deepit,Irshaad,Male,29-05-2011,deepit_irshaad_594@gmail.com,d8c753651424aac9109b3bcaf3756d94,91-7271922778,9,3,6,9,9,75,84
Charitra,CAELUM,Female,25-03-2008,caelum_934@gmail.com,df8a18c0bb8421d871cb1a9a4ae6740b,91-7545841945,6,96,39,135,6,45,51
Pragun,Shravankumar,Male,16-04-2013,pragun@gmail.com,752f44fc0c08f05f0045f1c0315a7b8a,91-7813259367,32,7,45,52,1,8,9
Kapardini,MAHEEN,Female,30-05-2013,kapardini_maheen_947@gmail.com,dea5359ef905ce3269df554dcbfed9fb,91-7516498648,1,99,1,100,3,9,12
Madhura,AL,Female,06-03-2005,madhura_al@gmail.com,40d154e4aa16f4f5999fe8cbb6c325da,91-7679569765,47,11,4,15,8,2,10
Neeta,Gyan,Female,2010-0-7,neeta_gyan_136@gmail.com,3f8891c6cc42b858cee657a56549589d,91-7428235624,5,13,9,22,6,4,10
Pitambar,CAVALLI,Male,20-05-2009,pitambar@gmail.com,e17a2dcbde6a556aa2158d984e58efa3,91-7438698577,26,2,3,5,94,9,103
Rukmini,Prahlad,Female,22-08-2011,rukmini_prahlad@gmail.com,18fd523920a52ef7fd4164b90cac266b,91-9535682131,24,6,16,22,51,53,104
Ajit,B,Male,11-08-2005,ajit_b@yahoo.in,7fa83cda256cd5377fb0ede5953a92d1,91-7741186966,2,48,3,51,45,96,141
AREEN,E,Male,10-11-2005,areen@gmail.com,175720bba742f489992dda82581ac954,91-7159114574,9,4,79,83,84,2,86
Nandita,N,Female,18-06-2012,nandita_176@gmail.com,24c96cc25c9c30f9b961892327d9003c,91-7543152693,73,7,22,29,46,27,73
Malini,C,Female,16-06-2005,malini_763@gmail.com,78695d98169e1b8b0b745f9c4e9e1ecf,91-7662296385,4,38,1,39,74,44,118
Teja,C,Female,20-09-2008,teja@gmail.com,2c31994258ee9db3f656ba8c635530a6,91-7496812816,37,5,43,48,1,51,52
CATHAL,Sheil,Male,12-09-2011,cathal_156@gmail.com,380205a12956f6192a0d87e51be79e63,91-7735989596,46,51,5,56,83,72,155
DORUK,C,Male,29-03-2006,c@gmail.com,f4d517de5c2e678a35b8774c17f4ab53,91-9122133115,63,11,75,86,82,13,95
Anuva,WOODY,Female,25-07-2009,anuva_woody_415@gmail.com,d353b75cb666b43241193141dd6a07f0,91-7263968527,64,15,5,20,48,8,56
Henna,Satrijit,Female,18-08-2011,henna_satrijit_356@gmail.com,07a1f8441e12800ac1159e4ebea5cddc,91-7762348467,47,63,7,70,81,28,109
Gyan,S,Male,08-01-2007,gyan@gmail.com,b7cc919930c3c906fed7c8669df4a201,91-9931318948,74,1,3,4,7,99,106
Urvi,CHAITANYA,Female,01-03-2012,urvi_chaitanya_689@gmail.com,705ffe4ac844c125d8b4ab79125857f5,91-7752167266,36,2,1,3,7,2,9
Viveka,F,Female,28-06-2005,viveka_296@gmail.com,c4e9778da86bee729a66eb001bd3f187,91-7549694628,5,8,58,66,2,3,5
RUEBEN,MIRACLE,Male,20-04-2006,miracle_935@gmail.com,3da3785b9efe99b1a4afa6558281e0fe,91-9341396768,5,73,12,85,2,8,10
Anju,Janith,Female,25-03-2012,anju_janith@gmail.com,4eba830354d2d97b8ace0fd55724234b,NA,0,0,0,0,0,0,0
Champakali,CHAY,Female,19-11-2007,champakali_chay@gmail.com,5d8a977dedcebfdef1e35b31bbd5a80b,91-9799988545,52,4,36,40,7,81,88
ANSHPREET,Q,Male,29-08-2007,anshpreet_q@gmail.com,454d675b5fe74cd3adedf8a1483ffe73,91-7124975967,55,78,4,82,13,2,15
LYLE,A,Male,16-10-2012,lyle@gmail.com,26488cb220124e72c22cc2b7694654bb,91-7866432144,6,3,54,57,53,8,61
Sarita,I,Female,11-07-2011,sarita_i_743@gmail.com,b55008af79ada564219cb8ad713fd72c,91-8225275786,82,22,5,27,87,95,182
Sona,M,Female,27-11-2013,sona_m_392@gmail.com,dcfba4b66959fb998a3b3478648c42cc,91-8154668264,54,1,9,10,3,5,8
Lekha,Y,Female,2010-0-22,lekha_y_179@gmail.com,9864473978fd2a345d45cbf5ebb5ef67,91-7993432694,94,35,58,93,69,1,70
Vasanti,GUILLERMO,Female,2009-6-31,vasanti_guillermo_268@gmail.com,7200408fb94c04e02c87e036a3070073,91-7263692577,1,34,3,37,82,76,158
Roma,FRANKLYN,Female,11-10-2010,roma_franklyn_675@gmail.com,5b32831253df3e9826fd46c70503a7ff,91-8397545549,7,15,5,20,5,5,10
Naganika,LARRY,Female,06-01-2009,naganika@yahoo.in,8ae6c0baeaa6528f761dcec70b30d5f1,91-7392915365,3,7,3,10,5,22,27
Ramana,T,Female,19-10-2012,t@gmail.com,b8902a67b85e35dc9adcd59b094d768e,91-7699349341,9,89,21,110,7,41,48
Mausumi,DARIN,Female,03-11-2012,mausumi_darin_217@yahoo.in,b21b0de6fc4dd0a5bbe781e6f4313a79,91-9486314168,84,62,7,69,94,2,96
Chandratara,KAYLEM,Female,08-07-2006,chandratara_kaylem_562@gmail.com,9a00a98b701804edcac14ec1f1bc3eed,91-7512243114,7,92,4,96,19,3,22
Punita,ISAAC,Female,11-01-2011,punita_isaac_432@gmail.com,0781c353a200547c882f078b2a5e6463,91-8755671385,83,7,9,16,3,42,45
Kirti,T,Female,10-10-2008,kirti_t_359@gmail.com,23dbe2289ff125ad906bfda74b938b9c,91-9156843457,2,58,1,59,25,8,33
CHRIS,TAHA,Male,19-05-2011,chris@gmail.com,9a56ab2d22b7ccc21a1d856b7a658f98,NA,0,0,0,0,0,0,0
EFOSA,ELIAS,Male,20-05-2008,efosa_476@gmail.com,a3461017cc273423bf48d30dbc6f7ffc,91-8741789134,49,5,4,9,41,34,75
Janhitha,P,Female,2006-0-25,p_435@gmail.com,8850d02166577cbbf522f2baaf06295b,91-9773569918,87,27,4,31,69,6,75
OREOLUWA,G,Male,08-11-2008,oreoluwa_g@yahoo.in,14b849aefed5f4fe399c0a45296c45f0,91-7679476692,3,26,8,34,74,35,109
Madhushri,O,Female,20-05-2011,madhushri_761@gmail.com,dcac37258954926c817c80682a29879e,91-9256674712,66,6,1,7,5,8,13
SOFYAN,Raghupati,Male,04-10-2013,raghupati_276@gmail.com,4f996df5111344d5b915d4ababc1ee91,91-7269327512,4,73,45,118,92,9,101
Harijatha,G,Female,30-11-2007,g@yahoo.in,39c91bdf49b51b57ea2dc167ae84b125,91-7296639597,1,8,3,11,2,2,4
FREDDIE,Vajrapani,Male,15-06-2009,freddie_vajrapani@gmail.com,c21da1764ed7363addf5819a884bec9f,91-9124932543,7,4,22,26,23,39,62
ANTONY,Krishnala,Male,06-03-2011,antony_247@yahoo.in,7ce28f5445ef6b0abfd2100ee8e9feaf,91-7918953584,56,8,7,15,67,69,136
Hamsa,BODIE,Female,09-06-2008,bodie_752@gmail.com,be67b06ab3be82865d253f61b313228c,91-8541465566,24,3,6,9,9,87,96
Sampatti,KYDEN,Female,22-09-2014,sampatti@gmail.com,576d7e587feadb7e908d6d6efe4a75ad,91-8335828574,65,9,2,11,4,39,43
EAMONN,NISHANT,Male,25-09-2008,eamonn_nishant_289@gmail.com,0867f0fc1dc78db98062c13638d4b521,NA,0,0,0,0,0,0,0
Dakshina,PEYTON,Male,2005-0-12,peyton@gmail.com,fcbc48efa8cc5ac5bcabc8d7ef07f406,91-8727662955,3,89,45,134,2,77,79
Maithilior Mythili,T,Female,19-07-2005,t_152@gmail.com,58b4c1269a28888c99c7f33b2e4def3d,NA,0,0,0,0,0,0,0
Jaspal,FINLEIGH,Male,04-11-2014,jaspal_935@yahoo.in,af6dd81333fe34380fc0c4c8088432ce,91-7369795843,94,59,61,120,7,69,76
Jayamala,AMINUL,Female,30-03-2008,aminul@yahoo.in,4e81da4d9d65a4ef792f9d1445a99190,91-9417498361,53,2,81,83,99,63,162
Murali,Vaijnath,Male,10-10-2009,murali_vaijnath@gmail.com,808d815ad68d3539f4ab15bab1540cfb,91-8383582629,5,96,99,195,7,96,103
FARREN,IBRAAHIM,Male,06-02-2010,ibraahim_862@gmail.com,6d00fbaba7f2cae7577dcdca93444eca,91-7195785287,85,3,89,92,2,5,7
Murali,Suryabhan,Male,06-09-2014,murali_397@gmail.com,5d684b93837a0d0e4ba8c0dda2649837,91-7914769969,84,6,2,8,69,8,77
THIERNO,Z,Male,09-07-2012,thierno_z@gmail.com,220a4eb16e241821ea5b7db006c2dd1f,91-7793219343,4,8,55,63,4,8,12
Indeever,ANAS,Male,19-01-2009,indeever_anas_742@gmail.com,e6b4c64ce607626d65ef55196f9ad018,91-7415835131,63,6,27,33,38,4,42
SAMPSON,FARRON,Male,09-10-2010,sampson_farron@gmail.com,e2e7e5f0c0bd08d89f95fbaf1d46b7fa,91-8612895987,3,13,3,16,2,93,95
Jasodhara,Sanabhi,Female,22-01-2005,jasodhara@gmail.com,8bd76bfa2f87a7ace1249adf5ca51659,91-9893187885,56,3,4,7,76,6,82
ASTEN,Aakash,Male,25-05-2006,asten_aakash_978@gmail.com,b1a96842f7273f8f213bc094b616a0e2,91-8633574116,84,29,6,35,3,71,74
Sahiba,B,Female,20-07-2005,sahiba_b_237@gmail.com,680accaecb81ca090078513536ff96da,91-7392184217,7,96,29,125,42,6,48
XION,SEAMUS,Male,21-01-2008,xion@yahoo.in,5bd3cc01dfdf4f69e44dd23824922018,NA,0,0,0,0,0,0,0
Dhanya,B,Female,26-02-2006,dhanya_b@gmail.com,3898361583921534846a8958fb93c4da,91-7933657824,8,7,4,11,63,58,121
Satya,J,Female,21-01-2012,j@yahoo.in,2180aa743c2855e03f354fc8797cc2f6,91-8177219111,46,5,31,36,3,3,6
Deepamala,K,Female,15-11-2011,deepamala_k@gmail.com,2765c9d4763cc82cffc76e3cd4bcba07,91-7992194251,14,4,4,8,47,8,55
Prajit,J,Male,25-07-2005,j@gmail.com,08f5bf7df3bfad4bd18b39ee4a13c772,91-7486599518,94,47,3,50,4,3,7
Chameli,ELLERY,Female,16-07-2009,chameli@gmail.com,f4968825242114a14fb74abf64480a7d,91-8437228949,8,8,4,12,33,95,128
Savitendra,SHEIKH,Male,2007-2-30,savitendra_sheikh@gmail.com,f407fddf9a137fc19cb2b080c152c41f,NA,0,0,0,0,0,0,0
KOBEE,V,Male,2006-0-22,kobee@yahoo.in,928f01709c7e48847e13ff7175e46b81,91-7177361888,7,43,1,44,4,92,96
RYAN,S,Male,12-04-2009,s_651@gmail.com,4f6138183075b920b3ce1e1f53328dfa,91-8866113813,42,1,2,3,14,5,19
MAHAMMAD,A,Male,25-07-2013,mahammad_a_325@yahoo.in,9bd01a8c7efc07637136941f876e0ee2,91-8851339572,54,1,1,2,6,36,42
YUNUS,Indratan,Male,04-07-2008,yunus_172@gmail.com,05d126db44dfd54dc8809e70d33f6522,91-7618572129,24,3,6,9,5,4,9
Shyama,BRAYDAN,Female,2010-0-26,shyama_braydan_815@yahoo.in,8bd187a8710eb2a529598247049cfa56,91-7544347386,86,44,99,143,8,5,13
ADAN,N,Male,18-02-2010,adan_n_271@gmail.com,5aa94b2745efca93bdae70d18b5bf9d9,91-9226897996,3,3,6,9,68,4,72
OLLE,P,Male,2006-0-5,olle_712@gmail.com,acd48cde4ffd8ccf67c0dd88d59760a4,91-9776231382,77,9,89,98,85,11,96
Turanyu,N,Male,06-02-2006,turanyu@gmail.com,436b19a2f0449cc7179cf36753f9a305,91-7722367875,5,25,9,34,96,8,104
Kurangi,U,Female,03-08-2006,kurangi@gmail.com,6abc9dc392b332adbaa909a1acb72ad7,NA,0,0,0,0,0,0,0
Gangika,OTAVIO,Female,2009-0-26,otavio_924@gmail.com,177eb09250d474dc02122b281380d0a4,NA,0,0,0,0,0,0,0
NIAZ,E,Male,30-03-2010,niaz@yahoo.in,d4d2a85dca5c720dc9e420e7d59b05c3,91-8143291339,6,2,3,5,7,16,23
Saroja,BLAIZE,Female,07-07-2007,blaize@gmail.com,8d0fa7640d8e0ae2597e0578947e894b,91-7391898825,99,6,53,59,5,66,71
Madhulika,M,Female,20-08-2005,madhulika@yahoo.in,02009aaafb96ff343415c3be4f37b541,91-7882539563,91,4,81,85,68,7,75
Aashish,W,Male,22-02-2005,aashish_479@gmail.com,801d50d681f82c3b06db8248d162a2b6,NA,0,0,0,0,0,0,0
Sadhya,Z,Female,02-03-2013,sadhya_z@gmail.com,4adfcd5b2b26e2041381e73cba7f218d,NA,0,0,0,0,0,0,0
Abhivira,Gunwant,Male,12-02-2010,abhivira_382@gmail.com,0757b0be543095e25191ba12a7026b8c,NA,0,0,0,0,0,0,0
Tarulata,LAYNE,Female,02-10-2006,tarulata_layne_137@gmail.com,e534d6ae26010a260630fb95d6cf6263,91-8239575675,67,4,76,80,3,3,6
Neelkamal,Himaghna,Female,22-08-2008,neelkamal_himaghna@gmail.com,29053a55cd0d4799e6e2e2e4113088de,91-9583839458,6,5,55,60,24,63,87
Amita,I,Female,15-01-2009,amita_i_416@gmail.com,30dc410d4bc88d69a711a38c4d7b9929,91-7314763164,4,61,28,89,1,5,6
MICHELE,N,Male,06-04-2012,n@gmail.com,ccf43d21e40a3d932ff8d4935f33f544,91-7977422628,5,34,6,40,46,48,94
Monisha,R,Female,18-02-2014,monisha_r_729@gmail.com,c0553e4d236dd12aa6db78bf46597ca6,91-7455162571,49,9,56,65,34,4,38
MARTYN,MUQTADIR,Male,01-05-2007,martyn_muqtadir@gmail.com,9d79e77846f08144fce6e30ff09ea656,91-8779389141,1,74,63,137,6,46,52
Nandika,Velan,Female,10-05-2010,velan@gmail.com,19ff113805882bef68d109ddbbe7dec8,91-7286523632,49,8,3,11,72,4,76
Amrapali,TARELL,Female,02-10-2012,amrapali_tarell_753@gmail.com,5fad065c2c02bea9f9db8d5e2936ce70,91-7752952698,3,7,17,24,41,3,44
KOJO,MORGAN,Male,27-09-2011,kojo_morgan_638@gmail.com,e2c355584b2f3812b8350857c18e6a5b,91-7694896338,83,1,57,58,71,14,85
Ekapad,BOAZ,Male,28-03-2009,ekapad@gmail.com,786b6ad2ea913fcfa456bc00462acae1,91-7811879548,92,71,44,115,6,51,57
SKY,JARON,Male,19-06-2004,sky@yahoo.in,df880a45a40a07b079f9b53d6518c8ed,91-8568916247,4,29,4,33,64,41,105
Chanda,CAMILO,Female,12-02-2004,chanda_camilo@gmail.com,cd70e162fb8f345365082696b5cb86f1,91-9555685157,55,4,5,9,46,76,122
Mutholi,JAMAI,Female,20-09-2013,jamai@gmail.com,87edec5c9bc9152151176e5dc9f913a1,91-9582972232,14,33,3,36,6,23,29
Abhivira,DEEN,Male,10-09-2010,deen@gmail.com,6b551de711bab8ec16d4660b39e618e2,91-7985452517,97,4,65,69,54,6,60
DENNY,Y,Male,02-04-2011,denny@gmail.com,c0fb6b8a00b314b2f2b82077d3c34c8c,91-7351447477,1,8,34,42,1,33,34
Sannidhi,K,Female,14-04-2011,k@yahoo.in,47a2f34a662af373256f0e8231ff1ccb,91-7712475592,19,67,1,68,5,3,8
Vasant,BENJI,Male,09-08-2007,vasant_benji_792@gmail.com,957596fe8c6820e4d00111f58dd90d66,NA,0,0,0,0,0,0,0
SONNY-LEE,G,Male,27-06-2011,sonny-lee_g_529@yahoo.in,75372ddb5475e95e2eaa6d5511ff0e27,91-9669766564,23,57,7,64,43,8,51
Shrilekha,ZAVIYAR,Female,30-09-2004,shrilekha_zaviyar_768@yahoo.in,1f2b388468d6db9a9737503d6f5cf91f,91-7744814392,6,1,73,74,2,7,9
NIKOLAJ,DHIR,Male,13-03-2009,dhir_561@gmail.com,b7d96afd635c84e9359ff4bb857331c7,91-7685799251,5,56,73,129,35,59,94
LUCAS-JAMES,Ishan,Male,22-08-2005,lucas-james@gmail.com,013b08f8450f285f614bc078aa3eb1c7,NA,0,0,0,0,0,0,0
Chadna,WAFI,Female,29-09-2005,chadna_wafi@yahoo.in,8963284e6fe12150bf275dfcfff0a71c,91-9727385939,3,85,9,94,85,2,87
Avantika,MIHIR,Female,2006-0-21,mihir@yahoo.in,ede970ec95e3f5ea35e6307b4526b868,NA,0,0,0,0,0,0,0
CLEMENT,JEREMY,Male,2005-0-6,clement_jeremy_815@gmail.com,4db85385484468cb546fbce5b6287bac,91-7748185587,9,6,76,82,3,8,11
Ishika,J,Female,12-06-2006,ishika@yahoo.in,9e7bd72ede049aec44c41ea550a3043b,91-7675225874,98,5,2,7,68,26,94
Debashish,F,Male,27-05-2006,debashish_f_246@gmail.com,2deecc2f3606d36cf2691bac189fb724,91-7558836451,61,1,34,35,25,95,120
NABEEL,RYLEE,Male,29-04-2007,rylee_846@gmail.com,b971d5462bfd3a6f262aa8737aacdf52,91-7523719597,34,73,3,76,27,9,36
Rukmini,Prakriti,Female,23-07-2012,rukmini_prakriti@yahoo.in,496d46dc773f21397aed2688f88cb6c6,91-8411774685,23,39,7,46,1,7,8
Manadha,C,Female,26-08-2007,manadha@gmail.com,320763c0829d0273a1c386cceb828240,91-8886655848,76,71,8,79,9,44,53
Parameshwar,ALIEU,Male,09-07-2006,alieu_431@gmail.com,b87b4634e416b55b88438aa7cdfb41a9,91-8721348172,8,2,6,8,7,24,31
LI,I,Male,08-06-2013,li_i_754@yahoo.in,e882e022eb42f6bfd85570850d64b07b,91-7155999674,86,3,32,35,6,34,40
Madhu,V,Female,2006-0-29,v_548@gmail.com,d50a1b8cd702cde37b805d90bf87f47e,91-9585583937,62,36,5,41,17,56,73
Pakhi,BILAAL,Female,22-05-2006,pakhi_bilaal_413@yahoo.in,9f7f1752cad12849316c8115f676b0a9,NA,0,0,0,0,0,0,0
Rishika,ITHIEL,Female,29-09-2005,rishika_ithiel_279@gmail.com,31b98a957d21b34d9c7988a18abfa068,NA,0,0,0,0,0,0,0
Manal,Dasmaya,Female,12-04-2005,manal_dasmaya@gmail.com,d46dd0885f7fdad5b3248b03331965e6,NA,0,0,0,0,0,0,0
EARL,AALIM,Male,08-04-2010,aalim@gmail.com,5513076c28ca8da9742610eeae507e13,91-7134748484,56,57,9,66,6,53,59
UMAYR,ARLO,Male,26-08-2013,umayr_arlo@gmail.com,193a3fb7af0bf7b6966216908d5aefd0,NA,0,0,0,0,0,0,0
Krishanu,LAURANCE,Male,23-08-2010,krishanu_laurance@yahoo.in,feb45907e03e814257ff47201e07b7b9,91-8257762188,31,93,66,159,94,35,129
Janani,IDRISS,Female,2010-0-1,idriss@gmail.com,f5e80b440632fa8e26bd384263ed7966,91-7549768985,91,5,5,10,23,2,25
Megha,X,Female,22-02-2005,megha@gmail.com,3dca75d7782b43d78bbe1610f094c4ec,91-8981778615,19,21,1,22,1,3,4
Foolanor Phoolan,Z,Female,2008-0-19,foolanor phoolan_z_519@gmail.com,4bca0688a4804a6181b7520d5a9ad63b,91-7237426139,3,2,8,10,29,48,77
Kiran,T,Female,03-11-2013,t@yahoo.in,8e6b0aede8351ebd8b7b8bd9ce91fa1a,91-8587784138,4,3,4,7,51,33,84
Nusrat,R,Female,21-03-2010,nusrat_r@yahoo.in,a6b10da52d2e227f4cbe97d2f9f5a170,91-7471521417,69,1,61,62,89,59,148
NASIF,FRANTISEK,Male,05-01-2007,nasif_frantisek_512@gmail.com,d0bf66f8eb743af0c49a5dd9a663daa0,NA,0,0,0,0,0,0,0
Hansanandini,Ekram,Female,22-11-2008,hansanandini_356@yahoo.in,14c8acfb759eb2d630127f3803ca1fc5,91-8486436478,6,7,41,48,93,6,99
JAICE,HUGO,Male,05-01-2013,jaice_hugo@gmail.com,9959c73943424afe0330695e320a39ef,91-8187884512,8,58,2,60,8,2,10
JORAWAR,IKER,Male,16-05-2005,jorawar_981@gmail.com,f82a931f040096ffce119689dd3b5d5e,91-7164452967,48,49,7,56,4,52,56
XANE,CHUKWUKA,Male,14-06-2012,chukwuka@gmail.com,9e949f157039ef202ad059cd074dfd91,NA,0,0,0,0,0,0,0
LEVENTE,Prasata,Male,06-04-2014,levente@gmail.com,e83101ec65d16068e6946e1caaa8399e,91-7982876416,47,1,31,32,1,98,99
Vindhya,Y,Female,20-04-2010,vindhya_y@gmail.com,41b50793ddc3d3b226aa811283c06832,NA,0,0,0,0,0,0,0
Rajeshwari,K,Female,11-02-2008,rajeshwari_627@gmail.com,6647a999908688bd5e3672cdb24e0484,91-8865234374,8,2,5,7,2,1,3
Dharendra,RICARDS,Male,17-10-2007,dharendra@gmail.com,dad0ef9411d92079b59410a2ba27f658,91-8582151373,4,34,44,78,5,5,10
Tanaya,I,Female,19-03-2008,tanaya_382@gmail.com,2e321cabbcbc929c696d70b11368b295,NA,0,0,0,0,0,0,0
Manyu,S,Male,23-08-2006,manyu_s_961@gmail.com,b6f8ca13443e4eda372652a3a8043516,NA,0,0,0,0,0,0,0
ANDRE-JUNIOR,J,Male,21-11-2008,j_687@yahoo.in,d91a089f1f9cabad03c48abb247cdae0,91-7982527569,1,73,5,78,2,77,79
Ranvitha,R,Female,09-10-2007,ranvitha_r_673@gmail.com,af15766f56d41def254c98ef2dff3021,91-9489682984,56,6,9,15,3,17,20
Nalini,IBRAHEEM,Female,24-05-2012,nalini_ibraheem@gmail.com,8be528b79eb915a90156811b1de3c738,91-8798819395,6,86,84,170,64,15,79
SPIKE,TALHAH,Male,07-02-2012,spike@gmail.com,c394e450c98f3f8a6fd4d382b3236eef,NA,0,0,0,0,0,0,0
MACAULEY,MALEEK,Male,05-07-2005,maleek@gmail.com,f3ad3faee79e8a951e43506659729217,91-7884874688,7,12,9,21,59,45,104
Jaya,U,Female,03-01-2012,u@gmail.com,8180e8205f210d64a19144f2fce97473,NA,0,0,0,0,0,0,0
Heera,Pulak,Female,25-11-2012,pulak@yahoo.in,06dde2ef37790d75145701ef1e982d1b,NA,0,0,0,0,0,0,0
Ratnabala,MOMIN,Female,24-02-2006,ratnabala_momin@yahoo.in,bd2c5cc8e0f98741a535e438a50ad458,91-8413674224,7,1,33,34,7,8,15
JAICE,I,Male,12-11-2009,jaice_i_134@gmail.com,ee88663ae4794519328be4691d0b6d63,91-8721854856,4,7,82,89,74,6,80
Varsha,M,Female,10-10-2009,varsha_m@gmail.com,df41036c200ceebc4d8df0d8b24d3fb8,91-7852898243,41,12,5,17,91,8,99
Pushpita,LOWEN,Female,29-10-2010,pushpita@gmail.com,4683b0784ed3de2fa84709a549f3b932,91-7745678795,36,63,75,138,53,83,136
Nabhya,Vidyaranya,Female,15-07-2011,nabhya_vidyaranya@gmail.com,75e7322ed387bc652d8ceba44227fc9c,91-7963965485,17,8,2,10,4,7,11
LEYLAN,FABRIZIO,Male,20-10-2014,leylan_fabrizio@gmail.com,f65c82ca065523dc261260c540e1d216,91-7755872433,9,29,6,35,35,67,102
ABDUR-RAHEEM,R,Male,03-08-2014,r@gmail.com,855a8d233e878204628867dee88df033,NA,0,0,0,0,0,0,0
PARIS,T,Male,16-07-2014,paris_t@gmail.com,f15a21abd2de2c8a8a5d324b0a5654a7,91-8136235612,7,86,83,169,85,4,89
JIA,V,Male,13-04-2005,jia_v@gmail.com,caab1b40cec99ad1a767b8de03f10018,91-7546656391,8,56,3,59,35,16,51
Gangika,Z,Female,16-05-2007,gangika_254@yahoo.in,ec0ece9ae3bbb47c8c92dd2c90c47589,91-9899638648,58,6,57,63,2,64,66
ABIDUR,V,Male,10-04-2012,v@gmail.com,06395cff3fcb7154c43d93f40122c7f1,91-9755974385,9,87,64,151,87,3,90
Ishanika,I,Female,2014-0-16,ishanika_684@yahoo.in,f8f448d37aa212e9f20666d98795e323,91-7822781975,43,1,1,2,6,73,79
JENSON-JAY,CAYLUM,Male,08-08-2010,jenson-jay_caylum@gmail.com,f873aebcc50b0a32f5e49b569270fdf9,91-9246827392,97,8,84,92,4,8,12
Ayesha,ARUSHAN,Female,29-10-2011,ayesha_arushan_937@gmail.com,2b61c7ccf232cbfbf7f45e4b1730e7ad,91-7443351464,44,27,8,35,4,23,27
Anjushrior Anjushree,AUSTYN,Female,06-09-2010,anjushrior anjushree@yahoo.in,1b2ed59fff11ec8411c1dbffa62bea78,NA,0,0,0,0,0,0,0
Harinakshi,YAZEED,Female,04-07-2007,harinakshi_198@gmail.com,a0974e20b728f59d9e71d77ab24a45a3,91-8726729288,1,3,4,7,5,54,59
Nalinaksha,Mahipal,Male,23-03-2013,nalinaksha_mahipal_592@gmail.com,ca4ac0da30ea991fe3a0fa2845b2b82c,91-9699496155,69,6,5,11,47,93,140
NOOR,MOISE,Male,21-03-2013,noor_moise@yahoo.in,0248c4224b1b23c35f4c6d370eabff18,91-8459827247,17,9,31,40,58,9,67
Abhirathi,NIVAAN,Female,22-04-2009,abhirathi_493@gmail.com,149c071cde3bbd381edecd90cbc6ab98,91-7945282654,52,16,23,39,6,78,84
MOUSSA,LI,Male,25-07-2005,moussa_li@yahoo.in,a33d9d94db95bef68a907344a032e78d,91-8571234686,1,73,52,125,56,22,78
YOGI,Manavendra,Male,01-03-2005,yogi_manavendra@gmail.com,63fda65596869ac5744e05e0ee8824d4,91-7783486995,17,2,66,68,6,33,39
Punyabrata,O,Male,19-06-2004,punyabrata_o@gmail.com,cc4473b0aa340f1e5a4b645bc4fc3cb5,91-8856867756,48,52,1,53,6,2,8
Kundan,E,Female,01-04-2004,kundan_e@gmail.com,84ac18711c8bb4a7a97c21ad42b6d5b1,91-8591399852,12,6,76,82,47,14,61
Sendhil,ZAKEE,Male,24-06-2011,zakee_429@gmail.com,54209e05e341655da40948f7abda2377,91-7337465942,39,49,55,104,95,5,100
OSIAN,FRANKIE-LEE,Male,20-11-2009,osian_frankie-lee@yahoo.in,a2f673f30b74f2d5e34b5df2e947ee83,91-9738587177,2,8,33,41,56,61,117
Farha,C,Female,04-03-2005,farha_c@gmail.com,783826e5abfc8502b42e77b8eeb60407,91-8753661633,8,99,6,105,36,7,43
Lokesh,Snehal,Male,25-06-2005,lokesh@yahoo.in,81d22d2de403520c705622f9891b3cf6,91-7121153948,8,4,38,42,6,36,42
Gunjika,U,Female,18-07-2006,u@yahoo.in,69afc47798e721dd63ded36d3f09e95f,91-8814287899,1,6,7,13,32,21,53
Kanchana,ADAMAS,Female,04-08-2012,kanchana_adamas_241@yahoo.in,174025ed732b2d61f9949ee1c42516ff,91-8114827823,7,6,34,40,35,61,96
Sunayani,F,Female,29-08-2005,f@gmail.com,af3936c221381cbb73be47c03edfb96c,NA,0,0,0,0,0,0,0
Fatimaor Fatma,Y,Female,01-04-2004,fatimaor fatma_y@gmail.com,20353a3d378b2884ebb9e66c4372758a,NA,0,0,0,0,0,0,0
Sadhan,TAMJID,Female,08-07-2005,sadhan@gmail.com,be0ae55e1033fce91d0cea97502b8905,91-7819612313,6,4,7,11,7,4,11
Guru,Y,Male,25-11-2005,guru_896@gmail.com,63df2e0c60c680aabd6b38bb7fe29c86,91-7372958849,63,84,8,92,9,7,16
Gudiya,IOLO,Female,29-11-2004,gudiya@gmail.com,cebabd4abc0702fa13eaa24248bb332b,91-9728184681,2,9,21,30,66,39,105
Suchi,Z,Female,25-01-2005,z@yahoo.in,1a6318ef30982509c24ba412035722ca,91-7154934778,98,6,3,9,6,31,37
Suhina,CAIRO,Female,26-06-2012,cairo_864@gmail.com,4ba3ed594b203bc1f836e8fe23642a98,91-7349517934,2,1,8,9,35,68,103
Leena,TALEN,Female,29-03-2009,talen_481@yahoo.in,fb3d8c136c1ad0f82716c325387f7a1b,91-9143852453,6,1,8,9,2,8,10
Gathika,MURTAZA,Female,01-06-2011,gathika_murtaza_827@gmail.com,46d81e414626e4cbcdc4a211bab4fc27,91-8596885143,92,83,6,89,74,1,75
Gayatri,SIDDHARTH,Female,06-10-2004,gayatri_613@yahoo.in,f6314ef070826a75316427b351f0cb24,91-9937254619,5,8,1,9,9,4,13
REHMAN,Harendra,Male,01-04-2013,harendra_173@gmail.com,da22d42a24d6853f5d89de863604991f,91-7566616987,2,16,11,27,9,61,70
Rajnandhini,LENNART,Female,21-09-2012,rajnandhini_lennart@gmail.com,71c6dc925ed0d557d58bb560956b1d27,91-7271224467,3,2,47,49,58,9,67
Bijal,Q,Male,26-02-2008,bijal@yahoo.in,578f35b88f3cb4a205e17afcb7ed989c,91-9615264926,35,2,82,84,7,65,72
Alka,B,Female,30-04-2008,alka_b@gmail.com,2ce9a9b4d972c566e80eb1d202ae1a14,91-7782986793,83,19,32,51,11,5,16
Gunjika,Bhadrak,Female,08-07-2011,gunjika_bhadrak@gmail.com,5d853c546191774af9390497eda3e549,91-8282165137,3,5,1,6,4,1,5
Phiroza,O,Female,17-04-2006,phiroza_o@yahoo.in,e9128a09ce3b8c36f92f186010975a99,91-9561743687,9,2,39,41,2,16,18
TYREESE,FRANKI,Male,2004-2-31,tyreese_946@yahoo.in,0ecd0979b82499502538382a34de07d2,91-8126558653,4,42,6,48,7,3,10
Vaijnath,Y,Male,08-09-2005,vaijnath@yahoo.in,8b77af53ccc7a3e06222539f7b079b46,91-7156549492,86,79,1,80,3,7,10
Sachetan,ELIAS,Male,21-07-2010,sachetan@yahoo.in,1c6c77b5b5f679a3cd2e85decc81824c,91-7825353816,7,1,3,4,9,23,32
Kayalvili,H,Female,19-05-2007,kayalvili_245@yahoo.in,1ef57f5d911edd0c891cb2d873eba4bd,NA,0,0,0,0,0,0,0
Hasumati,ABDULHADI,Female,15-06-2013,hasumati@gmail.com,031b3e3f0a61479a88ea531639f955be,91-7446665682,24,39,5,44,3,52,55
LUCAS-JOHN,Ilandevan,Male,12-08-2010,lucas-john@gmail.com,e6229c7f4147c209e67f1912d2a9d8a5,91-7764152768,7,34,1,35,4,38,42
Kavini,Z,Female,17-01-2012,z_586@yahoo.in,a80075c25ae7890c1576cbbdb20f7e5a,91-8281651475,62,8,6,14,13,56,69
Mukti,RAFAAN,Female,02-07-2010,mukti_rafaan@gmail.com,48a1f3023f4b8f4aab1c7469809fad1e,91-9619496734,8,24,9,33,6,19,25
IZAAC,KYRUN,Male,2005-2-29,izaac_kyrun_679@yahoo.in,0a5bf343cbabd1964b86cc5865ee4b13,91-7536971388,3,31,8,39,2,5,7
Lakshmishree,ABRAHAM,Female,09-05-2008,lakshmishree_abraham@yahoo.in,56fb8cac0447d53783e0224571f01f85,91-7327323656,9,66,86,152,3,8,11
SALMAN,D,Male,26-05-2005,salman_d@yahoo.in,17e993b41c2f015a18fd508b004e06f0,91-8449942151,6,2,9,11,72,95,167
Ashwatthama,SHADRACH,Male,01-05-2009,ashwatthama_shadrach_918@gmail.com,fcc68eb0b4df9ccb160972c7ac9dfc1e,91-7196525739,82,2,6,8,3,4,7
Vidula,O,Female,01-04-2012,vidula@gmail.com,f008c731eea4ba96830eaafe48c10e3f,91-9754631245,49,25,8,33,72,32,104
AJ,L,Male,21-09-2013,aj@gmail.com,f9065e76011059c609347b01c949bfc9,91-9314293225,2,84,7,91,96,81,177
Muthunagai,JOASH,Female,24-09-2013,muthunagai_joash@gmail.com,4a0c3aa7c654fd463a9929bc8ac4f3ca,91-7862128788,43,94,5,99,87,97,184
Supriti,E,Female,2009-4-31,supriti_e_763@gmail.com,93228f5866514f8d7b23f35835921be8,91-9184793885,33,82,15,97,17,2,19
NERO,P,Male,25-03-2005,nero_p@yahoo.in,9e4cc50b31f9cdc6d46a5321193d8487,91-7984148754,16,51,8,59,3,8,11
HRITHIK,D,Male,23-09-2008,d_926@gmail.com,2078a4ba02300bdcb06b90d1838e1446,91-7339628359,94,98,2,100,5,38,43
Smriti,Gunwant,Female,01-03-2007,smriti_gunwant_538@yahoo.in,5c2f1d3c6d31525f6513be9e535581aa,91-9823863894,98,1,44,45,27,7,34
Induhasan,Q,Male,2011-0-12,q@yahoo.in,485a9abf62d5bda8c1aee870d946010f,91-9586118526,5,1,9,10,42,1,43
Amoda,B,Female,11-07-2012,amoda_319@gmail.com,2d9b0512c23c9a1dc485a8e85711d64a,91-9819598549,3,6,58,64,36,82,118
COSMIN,C,Male,2010-0-30,cosmin_c_219@gmail.com,a5d6566dfee0c6d8de64f53b62871290,91-8313856839,1,45,18,63,25,3,28
Anarghya,RUFUS,Female,30-04-2005,anarghya_136@gmail.com,45537e6c3e6e4f5308e5ee55e7f55a9b,91-7151856848,22,8,73,81,47,77,124
TAJUS,Abhimoda,Male,28-11-2011,tajus_abhimoda_193@gmail.com,502b6a9f9c86ca9dc0f7571537783515,91-7958272953,12,41,7,48,59,29,88
COSMO,J,Male,24-07-2013,cosmo_j@gmail.com,4e63f6d68a71be2a424d03ac8e00930b,NA,0,0,0,0,0,0,0
Mahasweta,Palaniappan,Female,20-07-2009,mahasweta_palaniappan_319@gmail.com,b10f35b93fc3527afe60ee2aebe2737b,91-7281673272,95,5,52,57,9,44,53
ALEXANDROS,J,Male,25-01-2007,j@yahoo.in,71af62b18aec11a616189effe18d9f79,91-9778428872,5,3,82,85,78,48,126
Amrapali,N,Female,29-02-2012,amrapali_n_937@gmail.com,bef80cbb18d9c83f047fb3b2b608902c,91-7527244765,36,1,8,9,44,43,87
ARTURS,F,Male,28-09-2007,arturs_f@yahoo.in,a0dc87f6b285bf5916a1274a14f38b0d,91-7945115821,66,92,1,93,7,36,43
Madhulata,CAMDEN,Female,09-09-2009,madhulata_camden_195@gmail.com,d542fdcea47afa49b40ce56ed1ae25f2,91-9349234414,8,28,5,33,42,98,140
DHEVAN,GAMAL,Male,29-10-2011,dhevan_238@gmail.com,023ddc07fc1c2d4f36436d7438375698,91-7436218569,36,2,6,8,33,84,117
Tridhara,H,Female,13-06-2008,tridhara_h_329@yahoo.in,ba5051cbf6769694e02b68a284377b30,91-7158343297,4,77,91,168,93,41,134
Nishithini,I,Female,28-10-2006,nishithini_i@gmail.com,bd4c113580657e5f0befc020129ecaf8,91-9159826866,4,3,83,86,4,2,6
Trupti,D,Female,15-01-2008,d@gmail.com,e5a271ef676eda15c74cbccc266ba042,91-7729928332,62,1,87,88,5,8,13
RHYCE,D,Male,04-03-2008,d_712@gmail.com,ad1e48ddc5ec155967e60c1bcd42cafc,91-9769744994,25,9,72,81,53,31,84
Meena,Balakumar,Female,07-09-2010,meena@gmail.com,a63c056049be684eeb14467d16df7151,91-9562573613,84,12,8,20,1,4,5
KEOGH,MAISON,Male,19-05-2007,keogh_maison_321@yahoo.in,84dfd98e19a72df3c71b80d0a60473a9,NA,0,0,0,0,0,0,0
SOHRAB,BODE,Male,25-01-2009,sohrab_bode@gmail.com,18ec911bc91261aa303b85a4a78e1cfb,91-7856316746,2,89,8,97,9,62,71
Kamalika,KYI,Female,06-06-2005,kamalika_kyi@gmail.com,5fae37ce4624d6660080f815871f0fd1,91-7452385794,45,14,34,48,1,49,50
Anasuya,Arivumani,Female,18-06-2013,anasuya_arivumani_362@gmail.com,8457d36bc5ad0f71d5d66c4a4a668cbc,91-8636389862,91,9,44,53,4,8,12
GHULAM,D,Male,29-04-2008,ghulam_d@gmail.com,918bdea49b9ef1ea0a0caa3c5dfbc962,91-9144377446,21,57,31,88,4,2,6
UNATHI,SARUNAS,Male,16-07-2014,unathi_sarunas@gmail.com,231f8a87b63b369c088834d75d0647c2,91-7597581253,41,2,99,101,5,6,11
Ojaswini,C,Female,06-06-2013,c_189@gmail.com,3eaf148380c711741a11389b81d674b9,NA,0,0,0,0,0,0,0
Saudamini,BODEN,Female,05-06-2013,saudamini_boden@yahoo.in,7909c5fdd4fc268306ddf0ca236ae009,91-9292489856,14,42,2,44,19,1,20
Kailas,KAIZER,Male,01-10-2007,kailas_kaizer@gmail.com,7c4ec5640590549dec380f1f4bb12efb,NA,0,0,0,0,0,0,0
Santayani,Vasistha,Female,12-10-2010,santayani_vasistha@gmail.com,d66368569f5f0857498e4b4031524402,91-9253941823,5,1,9,10,5,5,10
Menmoli,V,Female,15-10-2008,menmoli@gmail.com,921aee93f38365a35ecca7c4aa84a7b0,91-7552495844,5,1,9,10,54,7,61
LLEWELYN,Y,Male,01-06-2011,llewelyn@gmail.com,967470072ab54c6442c670399b091eaf,91-8977498133,52,2,14,16,91,27,118
Yuvika,J,Female,16-07-2010,yuvika@gmail.com,13d1e4366d3dfeab69b541ba5f7a03b8,NA,0,0,0,0,0,0,0
TALHA,W,Male,19-09-2012,talha_239@gmail.com,345bf146b9169f0a4f364b5a32274c48,91-8818934932,25,79,2,81,59,83,142
CJ,B,Male,17-04-2013,cj_b@gmail.com,7cb4bb19e21d0962e6a3f7a12757eb19,NA,0,0,0,0,0,0,0
Anuprabha,F,Female,23-06-2005,anuprabha@gmail.com,d2f78b3998f5c62c670b36d6bfab2649,NA,0,0,0,0,0,0,0
TAYE,JASPAL,Male,13-06-2007,taye_jaspal_829@gmail.com,725f2e2bae352ddec87363df45b9e64f,91-9392265879,35,8,1,9,96,15,111
Kalith,S,Male,2013-0-28,kalith_458@gmail.com,4dfb1ad4fd5a531f5958f031cbc46009,91-7996416839,6,2,22,24,4,6,10
Tabassum,Y,Female,27-02-2014,tabassum@gmail.com,3c4331eaba9a876f441601b4c8ed2bfd,91-8223235754,9,39,6,45,5,4,9
ARCHIE,U,Male,27-03-2007,u_453@gmail.com,f24de7a3327ee04941d8a68de1f54b0c,91-9488196163,4,5,4,9,3,86,89
SKYLER,CALEB,Male,24-08-2013,caleb_412@gmail.com,69b6f682075feef9997c4510697883f2,91-9591532764,31,56,87,143,2,42,44
CUBA,T,Male,27-09-2008,cuba_t_736@yahoo.in,c9cd58c159abef15d0bd3df419ce356c,91-9944172749,28,55,4,59,88,5,93
Phanindra,U,Male,04-06-2013,phanindra_598@gmail.com,f39102a6e577e95094e8182abd7b2d61,91-7389378612,83,4,7,11,9,9,18
Tarjani,J,Female,30-03-2008,j@gmail.com,23e33d9b4890cb332468f200c66ef030,91-8955634324,9,8,9,17,2,4,6
ATAL,VIGGO,Male,2010-0-31,atal_viggo_376@yahoo.in,ac8cc2ba6484e1bb7df2a84f88bfba96,91-9247637318,19,59,1,60,31,19,50
AYMEN,X,Male,23-09-2011,x_613@gmail.com,f768d981b5aec3b9fd00073a27ad12d0,91-8928316555,25,89,55,144,42,6,48
COREY,U,Male,20-09-2006,corey_u_578@gmail.com,3defdd4bcc3d5c1bbe9e681edb514d3e,91-7614243323,7,54,29,83,68,5,73
AYOMIKUN,U,Male,15-03-2010,ayomikun_532@gmail.com,962fba5ef9c55842f960e113518ddaa0,NA,0,0,0,0,0,0,0
Kanan,E,Female,07-06-2013,kanan@yahoo.in,b04c759295839408fa37353a08a354b1,91-9867376614,94,4,9,13,17,45,62
MIHRAN,NILE,Male,2009-0-20,mihran_623@yahoo.in,ebb17ad9c009644c277d3f512b1c96e5,91-7266654446,6,31,67,98,71,1,72
GRANT,W,Male,2010-0-13,grant@gmail.com,bd0ef67a476a9813b3b70bc51684fb0b,91-9499815152,39,8,34,42,76,18,94
Yogini,J,Female,02-04-2006,yogini_817@gmail.com,37ea26e76c554e51485fc50bb163edc6,91-8189474642,84,61,17,78,7,6,13
MACK,O,Male,26-03-2013,o_853@gmail.com,0d1797dafb034e94ee736b514be8bd6d,91-7219631413,61,56,55,111,6,1,7
Senthamarai,C,Male,12-01-2004,senthamarai_732@gmail.com,1c1e1b5754e060a258755d3735e9e30a,91-9585458864,36,4,79,83,22,5,27
Parvani,B,Female,27-11-2008,parvani_b@yahoo.in,5d537754a96bb5349930a00eaf23c34b,91-7754992159,1,16,1,17,27,1,28
Poonam,C,Female,18-09-2011,c@gmail.com,291c8b8503da98ac97fee1ae6728c0b8,91-7631181351,3,8,1,9,61,1,62
Renuka,M,Female,12-03-2009,renuka_m_734@gmail.com,25411211a73a264679e42f3be8067ce2,91-9922652391,45,71,92,163,22,69,91
CHAEL,S,Male,23-08-2004,chael_s_971@gmail.com,2ae86d35e75e4f7777e50ddc83507549,91-7887134765,81,5,5,10,1,6,7
Bhanuja,SIMAR,Female,04-10-2006,bhanuja_simar_459@gmail.com,099148752c89d1adfb6cc7842f4f2685,91-7774781195,76,99,39,138,51,43,94
Atasi,K,Female,2014-0-27,atasi_418@gmail.com,3cf2457ab3c8502365b938c1ff2cc23c,91-7412677199,86,8,41,49,6,9,15
Charudatta,G,Male,24-10-2011,charudatta_g@gmail.com,6dea4b28d3c3e4ba72ea0c9761b22ca0,91-7719962364,84,2,7,9,62,17,79
Kanhaiya,Kailas,Male,30-04-2006,kanhaiya@yahoo.in,f7908b5a5c0a09d2c8392389f108bc01,91-7316324342,26,94,23,117,19,21,40
TOBY-LEE,M,Male,14-11-2008,toby-lee_431@yahoo.in,acdc2cb13d525b7af0429f27ab70b0af,91-7596467725,39,73,65,138,84,26,110
Ranya,ANDRE-JUNIOR,Female,08-06-2013,ranya_andre-junior@gmail.com,b35f06f8feab173723d763a5b5ee4a5e,91-7493367645,6,3,85,88,49,4,53
Anala,CODEY,Female,26-01-2008,anala_codey@gmail.com,11534fa45e25d5e4ff4f0955d67b6897,91-9642556943,2,4,56,60,92,8,100
Kurangi,Oviyan,Female,06-02-2008,kurangi@gmail.com,764d03703d945f33bcd9a2d6ed1d4745,NA,0,0,0,0,0,0,0
Kunja,X,Male,05-06-2014,x@yahoo.in,c23776e7b37380e2593202c8594bf21b,91-8971938672,98,5,9,14,8,14,22
CONNOR,Trivikram,Male,24-06-2008,trivikram@gmail.com,9e44ef7e3c901bab6320155f814eced4,NA,0,0,0,0,0,0,0
CLARK,C,Male,19-06-2013,c@gmail.com,c6e3b0d4d33a4989ff115fc00544205f,91-9697166177,4,23,9,32,62,39,101
SHAYA,RONALDO,Male,24-07-2011,ronaldo@gmail.com,ef37ca37ada4cba67e8f38f6d4d4f7cc,91-8177312126,21,19,6,25,9,44,53
ENIS,R,Male,15-11-2005,r@gmail.com,e9f5fc33e53513748009da4e65b9c2fa,91-7571798161,76,5,5,10,4,4,8
Maina,ABDOULIE,Female,29-04-2006,maina_abdoulie_458@gmail.com,5c94976b90a89525287dc93b8acb6f16,91-7985369137,62,8,36,44,4,98,102
TOMAS,Z,Male,17-04-2012,z@gmail.com,d55ca39f7d72f6829b6db0d39968d14f,91-7275481598,85,1,11,12,1,83,84
Pragati,MALAKI,Female,2007-0-1,pragati_malaki_498@gmail.com,76c735be13e7bd9cf8d31a282e2d35c8,91-7543524783,99,36,7,43,2,41,43
Iha,FRANKIE-LEE,Female,17-02-2007,iha_frankie-lee_791@yahoo.in,01a1055f55c420e76c762e9f7c5369b8,91-9928438223,44,8,37,45,12,68,80
Shishirkumar,LEART,Male,26-11-2005,leart@gmail.com,91c81042ac8ab9157661713729360f4e,91-7755745783,57,9,65,74,21,5,26
JAMES-THOMAS,B,Male,27-05-2007,b_934@yahoo.in,71cebf99c0c872b4edc82110e6b7c786,91-7832741383,44,4,94,98,7,27,34
DHARMA,BRADYN,Male,06-08-2010,dharma_bradyn_467@gmail.com,f08f1668c7f23d953b2ff990f14115cf,91-8177188448,9,2,77,79,4,3,7
Lochana,TASHAN,Female,2013-0-15,tashan@gmail.com,06741e1e56eccb320fb45cfcf119ee3c,91-8577989139,92,9,1,10,71,69,140
Gathika,JIMMY-LEE,Female,16-01-2008,gathika_jimmy-lee@gmail.com,b3b42208b691d2a9e4a09e540e5a210b,91-7473772568,6,5,9,14,6,33,39
Kanti,I,Female,22-11-2005,kanti_148@gmail.com,6a65103b4f72095aa7beb9a9ea61988a,91-8151429818,3,63,68,131,28,5,33
Hamir,A,Male,12-09-2010,hamir_519@gmail.com,1b93ab8ccb52cd2a5a8dc325dd4e26b2,91-8681836268,4,5,39,44,4,67,71
Vaishavior Vaishnodevi,C,Female,06-03-2010,vaishavior vaishnodevi_c@gmail.com,d5991dd236b124a164fa8e030ddeb253,91-7184246783,88,87,1,88,8,76,84
Kusumita,B,Female,27-11-2008,b@gmail.com,41e4a4ed8727ac1040b794ea9e4d9281,91-8434177969,3,7,2,9,3,4,7
Kuntala,AARYN,Female,14-06-2006,kuntala_aaryn@gmail.com,b730209181d0c95941a23955dbfdd6e7,91-8991434462,8,9,2,11,9,94,103
Vibhavari,N,Female,08-05-2009,vibhavari_n@gmail.com,b8362177b9b5e07f9564528968f59bb7,91-8117332757,5,3,57,60,1,7,8
Yogini,LAVELL,Female,06-06-2006,lavell@yahoo.in,01967694fc95d664f803bc3d7a7ae32d,91-7872494472,9,2,5,7,77,4,81
Krishnakali,MD.,Female,28-03-2012,krishnakali@gmail.com,8e67913686cfbef046caa6b6924d67ca,NA,0,0,0,0,0,0,0
Nabhanya,P,Female,11-05-2012,nabhanya_p@gmail.com,ff5a872c32a1f209d7ab2afcfd82e435,91-9283786467,9,3,14,17,6,3,9
Lopamudra,Aiman,Female,16-09-2009,lopamudra_aiman@yahoo.in,d1a5bf372ece0c27d6809cdb711fce0a,91-7321984616,4,1,4,5,41,88,129
ZAHEER,COREY-JAY,Male,24-08-2005,zaheer_corey-jay_782@gmail.com,35fdef109f2f65f9f3a98bf77ec9a320,91-9723135456,7,5,13,18,7,15,22
Jaimathi,E,Female,2008-0-26,jaimathi_e@gmail.com,b57c99d739e62e52cba21d65d25226fa,91-7483369797,77,37,6,43,6,2,8
SULAIMAN,JAHKAI,Male,05-05-2009,sulaiman_jahkai_184@gmail.com,2521279e80e9878a0e7864d84534aae2,91-8224719434,71,83,3,86,21,9,30
CHAICE,Prateet,Male,10-03-2006,chaice_prateet@gmail.com,6364ba53f88152ee474c6d4050f227e6,91-8519826175,99,75,54,129,42,8,50
Bhim,VLAD,Male,04-09-2011,bhim_vlad_928@yahoo.in,eccfde95753f66a88f55e8a70faf0031,91-7814511624,73,6,5,11,53,1,54
LAURENT,P,Male,20-03-2008,laurent_p_385@yahoo.in,b63520efb781d85fbdc3806e6f30dd52,91-7682822899,6,8,73,81,79,17,96
Amba,TYRONE,Female,26-09-2005,amba_tyrone_412@yahoo.in,3c1e4815d097bd647cdfbf3a252bd408,NA,0,0,0,0,0,0,0
RUADHAN,D,Male,20-02-2006,d@gmail.com,781901be4d5c70550d8f0453c6726bef,91-7797629984,48,74,13,87,48,7,55
Jithya,HAARITH,Female,18-06-2006,haarith@gmail.com,56f15063a3331b75e257df3e50b00abc,91-7413988975,4,9,69,78,61,4,65
Ekantha,J,Female,21-07-2012,ekantha_459@gmail.com,b5c4efb9238bf087887e900a20e9b326,91-7747543329,95,3,64,67,4,2,6
Nidhyathi,RANBIR,Female,23-09-2008,ranbir@gmail.com,bc5d9f63d36748926dfe45f8ff9768a6,91-7745134768,77,2,48,50,3,6,9
WILF,Pratiti,Male,02-02-2007,wilf_pratiti_276@gmail.com,e367b3634e5e9794a89047027921a8b1,91-8467426656,7,5,23,28,64,27,91
SAUL,Kundanlal,Male,17-10-2006,kundanlal_432@yahoo.in,a2394471f3a02940bb6d77f9a34e9d86,91-7937814977,77,51,75,126,65,31,96
KAROL,BERT,Male,19-06-2013,bert_547@gmail.com,c0f3b237e788bcb07c2793f2e48b8148,91-7141447555,33,31,4,35,93,96,189
Mansukh,Nikhil,Male,16-08-2010,mansukh_nikhil_782@yahoo.in,30b5022cf264dc444e6e5a1068b9d668,91-9795432848,82,89,93,182,65,5,70
Mehbooba,K,Female,07-04-2006,mehbooba_k_763@gmail.com,61816223335fac9752a9921621d13b0f,91-9329438164,73,83,9,92,2,8,10
SAMIM,AINSLEY,Male,28-08-2007,samim_ainsley_479@gmail.com,3129986af16a8de81fe29c2072f15d5c,91-7378219298,5,38,28,66,4,4,8
ALASDAIR,A,Male,05-02-2012,alasdair_a@gmail.com,bb5382719b57ad63074d170e68479fd5,NA,0,0,0,0,0,0,0
Esha,Prajin,Female,10-05-2009,esha_784@gmail.com,d2c1708600f31bcede76ca1d3360e720,91-8496647655,5,22,12,34,72,1,73
Kunti,M,Female,05-01-2005,kunti_m_784@gmail.com,15a839b80cb851e5a7a5b96ae39d2aef,91-7159229893,36,13,22,35,1,41,42
Khadim,B,Male,08-07-2009,b_984@gmail.com,76ffcd7630fae9f65ba937659727ebfd,91-8651758632,61,3,5,8,6,9,15
Maushmi,Divyesh,Female,31-07-2005,maushmi_divyesh_397@gmail.com,2fc21989b6b2b9d3da0ead07f7e40610,NA,0,0,0,0,0,0,0
Faria,U,Female,11-09-2011,faria_u@gmail.com,6746f07b9c70b5710156ae8f8f91fded,91-7123566276,9,15,15,30,35,1,36
Indushekhar,S,Male,26-03-2010,s@gmail.com,d53cfee3983adfa643abae9634bc145d,91-8475661991,25,2,55,57,2,17,19
KHAN,D,Male,01-03-2006,khan_d_865@gmail.com,c1a3fd48b709bf717296b64fdcd65f2a,91-7586269824,4,75,17,92,78,6,84
LYNDEN,REN,Male,2009-0-17,lynden_ren_795@gmail.com,34b002aeb8f3952ccffee0d87bb7bb5f,91-7893823651,48,29,37,66,39,15,54
Prathysha,ABDIFATAH,Female,2006-0-14,prathysha_abdifatah_928@gmail.com,582b931c424281767136c9fa98d2e631,91-8722875849,5,78,2,80,85,1,86
Suhitha,Z,Female,18-02-2009,suhitha_z@yahoo.in,3ae6e7a35a935469891df5555dc4bca4,91-7173755125,51,5,1,6,48,7,55
Loknath,A,Male,2007-0-23,loknath_384@gmail.com,7a218422372a649c1e89e8b2a2643c12,91-7134777289,6,3,99,102,8,7,15
Charusheela,M,Female,07-02-2013,m@gmail.com,94c1f3bc5f61d5ae3f66bf9baf909ad9,91-7586786937,87,19,3,22,5,6,11
Rajata,K,Female,22-01-2012,rajata@gmail.com,93cd54d0c50b0c3215085113ead6cdf4,NA,0,0,0,0,0,0,0
Hariganga,S,Female,28-09-2007,s@gmail.com,9356700794ddaf8e555e8f42411da0ee,NA,0,0,0,0,0,0,0
Shulka,Peeyush,Female,24-08-2006,shulka_peeyush@gmail.com,121b6ca37293408a2a710ba3f359cc72,91-7133993622,26,73,74,147,9,4,13
MALCOLM,X,Male,26-04-2010,x@gmail.com,97eeb8e1aadced984dbb7b737d25e75e,91-7753293772,7,85,23,108,74,7,81
NICOLA,J,Male,21-04-2011,nicola_j_458@yahoo.in,27c4d41fa4701a267d35ceb7bfbf5d48,91-7192583758,4,2,9,11,66,59,125
RAHEEL,B,Male,28-02-2006,raheel_b@gmail.com,5cb66933fac3e09dcfb5878e0bbd6a2d,91-9877373963,7,74,7,81,52,85,137
Aparijita,Fadl,Female,12-10-2009,aparijita@gmail.com,28ba56295dba6e0e3664189467c8157a,91-9679147525,1,88,7,95,2,48,50
Moulik,VLADIMIR,Male,14-08-2007,moulik_419@gmail.com,c7296332137990cfa50d919fff118aba,91-7491782249,88,4,12,16,1,84,85
NATNAEL,ROSHAN,Male,01-03-2011,roshan_418@gmail.com,5ea511b95d401f481b9cb8ff036c797d,91-7543656794,2,73,47,120,61,7,68
Advika,CHINONSO,Female,08-04-2012,advika@yahoo.in,047eb3b0758acacf94216d13f8b7dbef,91-9873327499,5,92,72,164,99,9,108
JUSTAS,P,Male,2011-0-6,justas_p_513@gmail.com,d0760e4832c887b89459b73335c0797b,91-7937564261,7,6,9,15,93,7,100
Sujata,S,Female,03-09-2014,s_658@gmail.com,d586009d01ac7c4f7aa2e80d2c6279d5,91-7421911145,5,53,5,58,19,7,26
Ajitabh,I,Male,04-01-2009,ajitabh_i@yahoo.in,6c733c1617e7614a7d9ea8ff408edd96,91-7862184971,7,37,75,112,7,6,13
JUAN,G,Male,26-07-2005,juan@gmail.com,ef3b026e77e6982d6b6f261517a0dd1c,91-7793893983,8,1,74,75,99,4,103
Amrapali,RUBENS,Female,26-11-2010,amrapali_254@gmail.com,af6cde4d9be648470a6590f7f5719371,91-7383663164,2,89,9,98,5,9,14
ETHAN-JACK,Udeep,Male,2004-0-4,ethan-jack_udeep@gmail.com,1a90a1e1957ae1ecbb7d7573b656581e,91-8599727968,78,1,5,6,6,7,13
OSMAN,Rajendrakumar,Male,26-07-2007,rajendrakumar@gmail.com,f95587763cbdb2a40260d4878a97010d,91-7895869381,39,41,81,122,74,7,81
Purujit,I,Male,27-04-2013,purujit_138@gmail.com,5e59cee69e5beed0b1e007c7a9d626c8,91-7254778584,67,8,78,86,33,2,35
JAVELL,T,Male,27-06-2013,javell_t_758@gmail.com,80a422e31a98e26baa225c6ff1941058,91-8253965449,34,8,6,14,16,4,20
Bandhu,D,Male,04-08-2010,bandhu_d_234@gmail.com,05f44285c0c8c158bc046ce61386e3aa,91-7147839291,31,55,1,56,7,81,88
SAEED,EMILIJUS,Male,15-06-2005,saeed@gmail.com,0f35b32b77a9e582e072cb7214368003,91-7948996571,1,4,17,21,85,81,166
CIERAN,P,Male,06-01-2005,cieran@yahoo.in,2e3b6edfd829f8de0ef5704a188a506a,91-7465738961,6,21,7,28,42,8,50
Vama,ABDUS,Female,19-11-2012,vama_abdus_945@gmail.com,251afc48bc6a8cb03a6111902f1c768c,91-7722949257,2,6,26,32,3,3,6
Manjushri,F,Female,13-05-2006,manjushri@gmail.com,73b2d71c067988a88371e39fbd0324a3,91-7759941718,53,14,9,23,2,4,6
Abhijvala,Swapan,Male,07-03-2012,abhijvala@gmail.com,843ca700795af87d8f6bfc2840fbbff4,NA,0,0,0,0,0,0,0
ANTONY,SEN,Male,25-02-2008,antony_sen_625@yahoo.in,f3916c47751de3185298d9a8c5c3e19f,91-9618997522,1,31,89,120,9,25,34
IESTYN,J,Male,28-06-2014,iestyn_j_354@gmail.com,8e0e366db21bcd2f0eea8e16bacf43e6,91-7884874631,48,17,66,83,22,9,31
Roma,IANIS,Female,2007-0-28,roma_ianis@gmail.com,6c49f7de98ab5fa1ec478097fee3dcd6,91-7843635158,7,11,51,62,4,7,11
Haripriya,SARTAJ,Female,06-06-2011,sartaj@yahoo.in,e3ab71d077bfbba5a2b9f73cc85e58f5,91-7478316333,5,8,48,56,1,3,4
Indumati,G,Female,26-06-2007,indumati_g_721@yahoo.in,f8a0f46bd3dd374e052af125c6d3a8b3,91-7559144386,1,9,98,107,64,8,72
AMRIT,U,Male,09-11-2010,amrit_u@gmail.com,23fd644f951a67cc5836b95d1661d7e7,91-7863659722,44,39,5,44,46,85,131
Uday,Mohnish,Male,16-03-2006,uday_mohnish_563@gmail.com,ff11e67fc8f01cbd838fe8a6fce5b15e,91-9833348866,4,8,2,10,2,3,5
Drupad,Q,Male,16-06-2010,drupad_q_674@gmail.com,9477fa618c7bf58ac88dbdcaeaccd6e6,91-8879287441,8,29,82,111,62,57,119
Nikhat,M,Male,04-07-2004,nikhat_m@gmail.com,eae00979a327f4efb0e29e43cd23c704,91-7541818956,27,31,74,105,24,37,61
Jayalakshmi,C,Female,2013-0-4,c_931@gmail.com,26698916ae18e29b90ddfc64e80d7681,91-7829548757,3,61,3,64,23,36,59
RILAN,DRU,Male,01-08-2007,rilan_dru@yahoo.in,e9155492856b9cff6134fa57c1f7148f,91-7256578271,2,48,12,60,4,7,11
Sadaiappan,Hashmat,Male,2008-0-29,hashmat_341@gmail.com,c975572b5a9496f598e1846960d0abe0,91-7583771733,3,6,71,77,74,9,83
Hardik,Q,Male,23-09-2009,hardik_q_358@gmail.com,88a0cfa2e30546007f622df3638672f3,91-9138397733,15,22,56,78,1,52,53
DAYAAN,H,Male,21-11-2014,dayaan_h_817@gmail.com,d4dafa43305a9459d26e91ffbe8a1572,91-8644272525,8,2,79,81,67,5,72
Anusri,YISHAI,Female,25-04-2006,anusri_yishai@gmail.com,487afd40fc2faed91456ba37622bc48f,NA,0,0,0,0,0,0,0
KONRAD,D,Male,2006-0-27,d@gmail.com,cbee0600df7032c0e3861526aa0bb616,91-7391537747,3,41,14,55,98,47,145
Buddhadev,N,Male,22-11-2009,n@yahoo.in,f7fd001b15eaebfcd6900b8a5dcade1f,NA,0,0,0,0,0,0,0
MUHAMMAD-IBRAHIM,TREY,Male,14-04-2010,muhammad-ibrahim_239@gmail.com,5ea9e4010ccf5fee7313e99b11bbc919,91-9111851463,15,74,21,95,4,2,6
Simranor Smaram,Y,Female,2008-0-18,y_975@gmail.com,f581d17b7e01d63ec114dfb7591a34e6,91-9528849858,38,3,21,24,12,8,20
UMAYR,ADEMOLA,Male,2014-0-27,umayr_ademola_832@gmail.com,be67d6cd7a4c0744987469efd291878a,91-9985445837,1,75,9,84,42,66,108
Trinayani,Q,Female,18-06-2013,trinayani_q@gmail.com,8118d277a8da441bc4dddc5110578efb,91-8162623875,44,23,33,56,9,3,12
Tara,E,Female,21-02-2010,tara@gmail.com,70515f5ff4d3e6a0b8d2c3f13bc89c26,91-9916792114,42,69,6,75,4,8,12
Devalekha,DORIAN,Female,24-09-2012,devalekha_dorian_297@gmail.com,a714b557088b0ea74798ef6013d7f8a4,91-9675338727,47,5,5,10,8,7,15
Pramila,V,Female,10-02-2011,pramila_v_597@yahoo.in,e8550264f51969c28519cfc3323ecc5c,NA,0,0,0,0,0,0,0
Mudrika,KOSHAN,Female,08-10-2010,mudrika_koshan_398@gmail.com,3cd4bd049f1546e2cb96f0a3bab28146,91-7299588426,8,18,6,24,2,2,4
ALIX,TYLER-LEE,Male,21-04-2005,tyler-lee_752@gmail.com,72a79056c49091516151427f37424e8c,91-7742312368,32,68,7,75,7,3,10
CAELEB,Lakshmikanta,Male,14-10-2005,caeleb_lakshmikanta@gmail.com,fcde0b221e4c3c5b306ca6e79a5907c6,91-9574538828,5,48,8,56,27,1,28
Parthivi,C,Female,09-10-2005,parthivi_c@yahoo.in,d8a6973802430de5e0b19c8a7b9d59ea,NA,0,0,0,0,0,0,0
KEIAN,Acaryasuta,Male,11-10-2010,keian@yahoo.in,15822d957679be6eaf1f1ec8cfd073a1,NA,0,0,0,0,0,0,0
LOCHLAN,C,Male,22-04-2007,c@gmail.com,47118c759c0e3a49849a3e0ca2ed8eed,91-7662896619,8,7,3,10,6,85,91
PAVOL,Swagat,Male,17-08-2006,pavol_481@gmail.com,f1be808eec2351f4d49076d63ad23fab,91-7754983526,9,9,5,14,7,6,13
Nimisha,JAGAT,Female,05-11-2012,nimisha_jagat@yahoo.in,d907815623410d21e8bba3babcbe1d54,91-8612131989,1,69,2,71,65,26,91
Soumyakanti,AMJAD,Male,07-05-2013,soumyakanti@gmail.com,074b120024b8a7a5d7b27abd63e7ac26,91-7728352572,5,9,31,40,39,2,41
Shreyashi,E,Female,19-04-2007,shreyashi@yahoo.in,d67662f9a29b0d67d1dcb70719389fd0,NA,0,0,0,0,0,0,0
Arya,P,Male,15-08-2006,arya@gmail.com,f7d932e14be0befd60e304ab448bef31,91-7117414374,59,1,6,7,4,2,6
Ranya,B,Female,15-08-2013,b@gmail.com,dec9381d42f5e07af8770049d4898b29,91-9519566819,7,81,7,88,28,5,33
Mayil,C,Female,16-05-2011,mayil@gmail.com,dd339c1f8d16185d400a120773209e64,NA,0,0,0,0,0,0,0
KODA,J,Male,2008-0-18,koda_j_548@gmail.com,0dc5dc38e577b72f2cb58f7a1664d5f7,91-7595288953,99,3,4,7,6,1,7
Sadguna,Narendra,Female,21-02-2012,sadguna@yahoo.in,0a17a5a6481fce7922249eabd6dbaef3,91-7745383478,38,8,26,34,72,92,164
CHAISE,Mahtab,Male,2009-0-4,chaise_mahtab@gmail.com,738385ee26f4e477d204215925744e7c,91-7821133214,95,7,9,16,98,2,100
SALVATORE,GABRIELE,Male,28-04-2006,salvatore@yahoo.in,bedc49cbdb6ec902d1263b4754685aaf,91-7459735184,3,18,6,24,7,61,68
DOMINIKS,ORAN,Male,12-07-2011,dominiks_oran_651@gmail.com,c7024229c2122ba5af87c5bd1355c9c0,91-7327177323,82,9,9,18,95,45,140
Mani,V,Male,24-11-2005,mani_v_413@gmail.com,21238343dea1a480ae4b68e0de91badd,91-7891144358,17,79,3,82,6,8,14
Sharmila,D,Female,02-05-2008,sharmila_d@gmail.com,f90334c472834e67e0e41fc12031296f,91-9438258257,3,2,8,10,52,9,61
Sarita,REILY,Female,2011-0-8,sarita_reily@gmail.com,f9bbfddc2adcc6fcef51a04179dbf9a3,91-8917519754,92,79,15,94,32,4,36
Sarvika,M,Female,17-02-2014,sarvika_m@gmail.com,36b42001718b6210284041034f31b425,91-7955526912,59,51,3,54,97,81,178
Shridevi,Bhaskar,Female,20-07-2011,shridevi_bhaskar@yahoo.in,43926fbb1141531d718a0ce2bf69e018,91-7974396976,65,89,41,130,9,68,77
Tamasa,ALLAN,Female,14-02-2005,allan@gmail.com,39ce5c4a4a17abc90844a9ab71ba2736,NA,0,0,0,0,0,0,0
NICODEM,Govind,Male,21-02-2008,nicodem_govind_547@yahoo.in,577da461a260b14cd1943bafcdb98901,91-8664619678,2,12,2,14,78,43,121
DEMARI,Z,Male,05-03-2007,demari_z_965@gmail.com,56a133888a2202ec0f51f4c860389ff8,91-7623889376,7,92,9,101,2,82,84
Mridula,SMITH,Female,28-06-2004,mridula_smith_538@gmail.com,a83aedfd8d0a199c65a7c72a2a622962,91-8399136976,9,6,7,13,6,8,14
Sukriti,Sukrit,Female,14-07-2005,sukriti_241@gmail.com,ecd00f2c6461185159c15c8e9a84eea4,91-9921548621,57,28,1,29,24,47,71
TALLON,J,Male,28-05-2009,tallon@gmail.com,5336af1f2a054db09cdc2ecebe63394f,91-7329549373,88,26,9,35,28,9,37
Rebanta,H,Male,01-09-2011,h_756@gmail.com,c027673a0238dcb92bb9a240325977c3,91-8842873414,8,3,21,24,57,94,151
HARRINGTON,M,Male,11-06-2012,harrington_m_154@gmail.com,b437471823c050182e15483c7c6083e9,91-7123695544,96,69,41,110,54,4,58
Arun,KYAN,Male,25-07-2011,arun_kyan_621@gmail.com,eed5a0890ea2703b7e128c8d8d39d342,91-7236713818,8,23,85,108,8,11,19
Chitrani,ILYA,Female,29-03-2005,chitrani_ilya_524@gmail.com,46eb92c82fe5a81ab4d3031db6523bd1,91-9941288319,55,7,19,26,4,35,39
BLAYNE,IMAD,Male,29-04-2006,blayne@yahoo.in,f95ac1d1a660d0748c291493c92f360b,91-7715138525,1,78,3,81,6,21,27
Vaijayanti,Vrajanadan,Female,11-06-2004,vaijayanti_vrajanadan@yahoo.in,677c85fbe1e6ceaba5fa5119c4ced626,91-7891216781,11,3,4,7,1,38,39
OLIVER-JACK,Q,Male,28-02-2006,oliver-jack_q@yahoo.in,844bdca9ccfeaaaa3692d2e177de3bec,NA,0,0,0,0,0,0,0
Shubhra,Unnat,Female,18-05-2011,shubhra_unnat@gmail.com,c6858f2ee922a1c9326a9fbf75069fca,91-7759948782,56,25,51,76,7,17,24
RAJAB,U,Male,07-02-2008,rajab_u@gmail.com,3bfa74883da5336dfedefa1b4f9b03cf,91-8237331168,66,52,28,80,24,9,33
Shachin,PREM,Male,07-02-2009,shachin_prem@gmail.com,890cf1238735844aad9ce47ff0077365,91-7876282914,1,23,4,27,7,8,15
Senajit,J,Male,30-07-2005,senajit_j_872@yahoo.in,47c98977bd72f044e90675e3210dc648,91-8729382463,7,9,8,17,56,1,57
KAVEN,ANSEL,Male,15-11-2014,ansel_283@yahoo.in,a06ee4e74dc562f0e9cede429352ec92,91-7391723791,7,7,45,52,7,95,102
PATRIKAS,R,Male,27-07-2014,patrikas_r_297@yahoo.in,fe83cd93fba67d058d4cc04e9ef9ea73,91-7225362183,68,23,5,28,16,27,43
KUNJ,ALBIE,Male,24-04-2005,kunj_267@gmail.com,978cb256af6a34b61c758c26b1580a8e,NA,0,0,0,0,0,0,0
Chameli,TAIWO,Female,07-08-2005,chameli_taiwo@gmail.com,c74eed87a394a287a390dca5a492adb2,91-9223112933,9,71,37,108,85,3,88
ADNAAN,ELY,Male,02-05-2005,adnaan_ely_524@gmail.com,49719a1a101a378811bcf52216d34bd8,91-8416764365,61,3,8,11,99,33,132
Makshi,AAMIR,Female,28-01-2006,makshi@gmail.com,b86c70a16806df412d44979c1e04db62,NA,0,0,0,0,0,0,0
Jyotika,N,Female,18-11-2005,jyotika_689@yahoo.in,cf289662bd23bef3869930cbda231278,NA,0,0,0,0,0,0,0
SHAMARI,T,Male,02-05-2009,shamari@yahoo.in,6e1d4b46471a08a7411dde85f153bb98,NA,0,0,0,0,0,0,0
Parnik,Q,Female,20-10-2004,parnik_q_974@gmail.com,260239ea02f15ebe47bcabc10179a139,91-7958517321,56,8,47,55,13,31,44
ANASTASIOS,ROMANO,Male,03-09-2011,romano@gmail.com,93c22b37d75c295717a0318740d3ab5e,NA,0,0,0,0,0,0,0
BRODIE,H,Male,18-08-2004,brodie_317@gmail.com,7b3098191d15c7109e2b7381c39cfc59,NA,0,0,0,0,0,0,0
Varun,KRIS,Male,27-02-2013,varun_kris@gmail.com,775c7c5ea1f09664d25bf94884ad8b4c,91-8122149217,23,19,7,26,37,39,76
Eshanya,RIYAAN,Female,07-02-2011,eshanya_riyaan_291@gmail.com,b3d93b83f787c63b4c049e2b4460c094,91-9938867389,36,5,3,8,1,12,13
Sharika,Bhagirat,Female,21-04-2008,bhagirat@gmail.com,224957d1a381a587a1ba386a300b1f14,91-7832823494,4,1,28,29,2,93,95
Shrilata,Q,Female,2005-0-19,shrilata@gmail.com,724625d593e607989aca1fa9c941a395,91-7559146311,38,9,6,15,2,88,90
Tapti,KIEL,Female,05-01-2009,kiel_637@gmail.com,fe14dd2c2616233fe45161b819166d08,91-7278762889,36,9,1,10,86,3,89
Saroja,Manmatha,Female,18-08-2008,saroja@gmail.com,dab8b02cca0e4657ff82b396101060b7,91-7149996213,7,7,5,12,86,8,94
BARTEK,G,Male,30-09-2005,bartek_g_917@gmail.com,95d84614697ee5966b8d344a8531cd0b,91-8853472927,1,17,4,21,2,92,94
IANTO,Vinesh,Male,15-01-2005,vinesh@gmail.com,0b361ca1bd3fad7a2aff6fcdf61f918b,91-8154653522,17,3,5,8,12,2,14
Kaushal,DANNY,Male,2005-0-27,danny_693@gmail.com,378cfcfa50d8afbd0dad5d39f3c58b1d,91-7294512298,2,4,93,97,1,2,3
KAI-MCKENZIE,C,Male,15-01-2007,c@gmail.com,2548b7ab733f02c15e9ef4b5b813bfcc,NA,0,0,0,0,0,0,0
Arunima,K,Female,14-03-2005,k@gmail.com,253d0ef6145a9bce23c11cebf9034746,91-7417695349,5,9,65,74,48,7,55
Mayukhi,COLE,Female,2005-0-7,mayukhi@yahoo.in,84a1d4d36c53cdff0c5835ff12c4ded5,91-9949465135,95,21,8,29,18,4,22
Parveen,W,Female,2013-0-1,parveen@gmail.com,11307380117982b02602b7b3f8d3e3ec,NA,0,0,0,0,0,0,0
DYLON,KAEL,Male,22-01-2004,dylon_123@yahoo.in,654b807327127e9406d7a609d77ef181,91-7995961444,63,51,3,54,63,41,104
Taruni,D,Female,28-07-2010,taruni_d_561@gmail.com,1856986bff5914c788b1d87252b42ed5,NA,0,0,0,0,0,0,0
Gurmeet,I,Male,29-06-2011,gurmeet_i@gmail.com,3a545e4e7cfba5b96a0d80de1b595d7b,91-9495593836,27,2,2,4,4,13,17
Devasree,AREL,Female,19-06-2006,arel@yahoo.in,8d4921922ceaee7ecf4cbfa0d034e868,91-9564952584,6,28,7,35,7,13,20
Pritika,P,Female,23-07-2005,pritika@gmail.com,fd6619f2a47262fdb95b1e6cb7af9a45,91-7121963886,6,65,5,70,2,3,5
Kangana,RAMSAY,Female,29-11-2014,kangana_ramsay_896@gmail.com,808e338e9fa3f64b10eec38ead1483de,91-9641479535,19,6,5,11,77,74,151
Muthunagai,E,Female,2012-9-31,muthunagai_e@gmail.com,47c515c901344b54c8abeb6e87360246,91-7479122729,9,51,5,56,55,3,58
MARTELL,Y,Male,2008-0-30,y@gmail.com,1605b7062db64553ed2afe3cf1d2393c,91-7667832122,2,56,7,63,59,5,64
Mahiya,SIMON,Female,28-08-2009,simon@gmail.com,b0a1eabb12e06385aeabd3cbc854e702,91-7712184661,74,33,57,90,8,5,13
Poornachandra,K,Male,07-06-2011,poornachandra_k_673@yahoo.in,5bddcc23f4cac90f157c54e19c29c5a4,91-9997263799,5,4,7,11,57,56,113
Amritkala,Nivrutti,Female,13-02-2007,nivrutti@gmail.com,b4d5b02d2c116aede23f56e882f99846,91-7286153467,1,81,48,129,23,36,59
Hatisha,Q,Female,17-01-2005,q_628@yahoo.in,c34e35a8207ab36e2fb02716f556a0aa,91-7568555625,3,9,67,76,67,6,73
Kaumudi,ROSSI,Female,17-04-2007,kaumudi@yahoo.in,828c2bb2437709c84846dad0347c8a05,NA,0,0,0,0,0,0,0
Anusri,COREY-JAMES,Female,19-02-2004,anusri_corey-james@yahoo.in,bfb9d702b0410294363b5d781af16d07,91-7613641279,7,9,52,61,43,54,97
SAMUELE,T,Male,23-08-2010,samuele_t_543@gmail.com,8ee4894874b104af25d2bc3e2a1e2da0,91-7134723733,7,2,71,73,9,29,38
NYLE,BOBBY-RAY,Male,26-04-2004,bobby-ray_281@gmail.com,daafd8157c9d38b0b568b992884417ec,91-8816515744,56,33,67,100,7,6,13
ARIYAN,Y,Male,06-09-2014,ariyan@gmail.com,2e44bf0501a7cfa4bb652fc147dc3eac,91-7626769991,6,56,77,133,91,8,99
Devajyoti,Vachan,Male,04-01-2011,devajyoti_vachan_641@gmail.com,79d81e1b260d852a22cb69ec59a7f1d8,NA,0,0,0,0,0,0,0
LEVY,M,Male,20-03-2004,levy_m_257@gmail.com,9585fef2ade52878e02f880889c8e660,91-8557383425,5,89,6,95,4,66,70
DAANYAL,A,Male,11-06-2010,a@gmail.com,6f3330ff079a0c146762d17829722cd7,91-9316886825,1,8,69,77,4,6,10
Chapala,H,Female,04-08-2005,chapala_h@yahoo.in,a7e7f5ad7412adea18e46c5e37b71640,91-7362518874,14,7,46,53,1,42,43
YOSSI,RAYAN,Male,27-03-2009,rayan_832@yahoo.in,14b99455a972f92fb442e07d126de92a,91-7264278176,67,8,95,103,3,34,37
Neeta,AAQIB,Female,04-05-2012,neeta_aaqib@gmail.com,6c5229979820da09b5b88b6eb3b03612,91-9846479661,77,8,8,16,53,1,54
Saroj,DAVIAN,Male,2010-0-29,saroj_davian@gmail.com,036898f4fbafbdb54c606cde45f42f46,91-7345859549,88,12,9,21,7,81,88
Chitramaya,BUSTER,Female,29-04-2013,buster@gmail.com,defb46d783c29e7ef724a938c4243d82,91-8785966133,7,43,3,46,2,2,4
Raakhi,ELWOOD,Female,28-11-2013,raakhi_elwood_615@gmail.com,19b2605eda078d1d6e2d7308b0ead304,91-7554559892,6,33,8,41,1,73,74
MOHID,C,Male,26-11-2004,mohid_c@gmail.com,64f65397943ec42645df89612bb139ac,91-9396357719,7,5,4,9,76,5,81
Nivedita,OISIN,Female,10-06-2011,nivedita@gmail.com,afa1b541e4823d7699674029e9aebd5d,91-7597649999,11,6,42,48,2,28,30
RIVERS,S,Male,06-10-2013,rivers_s@gmail.com,56022d0751fa5fe9002a95965ec63d5c,91-9264246789,7,2,65,67,7,95,102
Devalatha,ALVI,Female,24-03-2005,alvi_357@gmail.com,27cf824cb3ba8451231abe14f1a21d0b,91-7112747115,19,29,2,31,9,65,74
Sammathi,Priya,Female,07-03-2005,sammathi_priya@gmail.com,7ee92edb14ae3dc126e6f65d4c81cf3d,91-9413687218,6,6,98,104,85,5,90
PARAMVEER,THIERRY,Male,16-01-2006,thierry_691@yahoo.in,508483701bf77b858f24ed4027285c17,91-9719663124,7,63,6,69,77,9,86
Soumya,MALLORY,Female,16-01-2009,soumya_157@gmail.com,da8b23aba7d1580e9d5494d293659e91,91-9769937853,32,65,78,143,96,5,101
Radhika,Premal,Female,01-03-2004,premal_679@gmail.com,b91a93edfa6f1398d33dfc3b88eab6ac,91-9759163298,73,1,5,6,4,46,50
Sasmita,V,Female,22-10-2012,sasmita_612@gmail.com,f2f573925dc9d860fd66528d7d656395,91-7132631478,6,43,6,49,7,8,15
Ahijit,Teerthankar,Male,29-11-2005,ahijit_teerthankar@gmail.com,ee5793ddc44f3e403a786c86aaa7eeb1,91-9534993732,1,9,1,10,1,16,17
Mohan,F,Male,16-07-2008,mohan_f_679@gmail.com,2d0073c72de677a2b5ce744061c112a7,91-7123373661,82,9,6,15,94,4,98
Ela,J,Female,07-01-2008,ela@gmail.com,92095b550d3163a124051b51cc11f30e,91-9298794838,13,8,51,59,5,84,89
Jograj,F,Male,15-08-2013,jograj_f@gmail.com,3fa22ad95516e69706324c80be23d74b,91-7478858463,6,1,81,82,77,25,102
Varsha,RAJAN,Female,05-09-2013,rajan_357@gmail.com,2d630764a10ae575f6b352fd403330d6,NA,0,0,0,0,0,0,0
Saphala,C,Female,04-05-2010,saphala@gmail.com,0d2b6e1985a0ad7ac9325951885fa718,91-7219446772,68,4,1,5,81,1,82
Dhanya,G,Female,22-05-2012,dhanya_g_965@gmail.com,02d788dc0d2928a3fb2f93b7cb687f77,91-8373176519,74,8,29,37,44,1,45
Hariraj,J,Male,29-06-2013,hariraj_j@gmail.com,2df00512ee72bcde631a0962ded422a0,91-7856938231,7,11,7,18,75,38,113
Shobhna,F,Female,13-07-2009,f@gmail.com,24c5baaa394e352cc16bc23c14a2e1ea,NA,0,0,0,0,0,0,0
Kuntal,Y,Female,29-04-2014,y@gmail.com,c9ee044b8f7928f0e1853cba3c13bc87,91-7766194416,5,1,7,8,7,2,9
Kshanika,Q,Female,04-07-2005,kshanika_218@gmail.com,64c4d6c89c4d8b0595bc6b6e4324943f,91-8135823498,9,8,7,15,6,6,12
Akalka,Daksha,Female,15-08-2007,akalka_daksha_371@yahoo.in,2c88f6f74cd3def09065831df40272f2,91-9329694856,6,4,12,16,71,85,156
TYRELLE,Anjuman,Male,24-07-2004,tyrelle_839@gmail.com,1533b1e2f1f0f6f8f1f7fef924823ab7,91-8625212334,98,76,42,118,8,94,102
Anuga,U,Female,24-07-2006,u@yahoo.in,dbaa812a9ced4957c75310b6f3d11938,91-7839726934,9,5,33,38,9,8,17
TAYAB,E,Male,2006-0-4,tayab@gmail.com,b3f63e4cb8e9cc23f1568b815d648fe9,91-9714216819,3,26,85,111,72,6,78
Nithilam,A,Female,2009-0-4,nithilam_a@gmail.com,5eaea997868951cfc8031c36e60ceff9,91-7521361346,66,3,26,29,47,35,82
Jetashri,Y,Female,05-09-2011,y@gmail.com,68138a77c3e067c93fb7d80dca3ca91f,91-7536352767,15,9,1,10,98,8,106
Quarrtulain,D,Female,01-09-2014,d@gmail.com,3d037971ec990021ed8bdc7e5444e47b,91-7481964119,9,5,1,6,1,53,54
Jayantika,ANDERSON,Female,2005-0-25,jayantika_anderson_915@yahoo.in,00e7d29abda654535a996b75eae89b3e,91-7996595583,47,97,1,98,38,3,41
EGOR,K,Male,23-05-2012,egor_k_129@yahoo.in,a9834f6b3cb31560595c24ac0443f50c,91-8396445823,9,39,8,47,8,8,16
ANISUR,NAJIB,Male,29-06-2006,najib@yahoo.in,3d3386641aa9d1fa3c87e588ff80ebd2,91-7546643411,9,4,2,6,3,51,54
Sushma,Y,Female,22-03-2011,y@gmail.com,756c9603dcb7f4c58bdeba5853df88ea,91-7534571747,65,4,76,80,3,13,16
Manishaor Mohisha,OAKLEY,Female,10-08-2011,manishaor mohisha_oakley_738@gmail.com,ab71453eac25c35b84724599aebaeb3b,91-7176788128,46,2,25,27,6,9,15
LAYLON,I,Male,24-08-2010,laylon_i@gmail.com,78ec684b79be35d5d3de25c6e7efdc7f,91-8229127511,25,74,73,147,45,2,47
Gudakesha,T,Male,06-01-2012,t_634@gmail.com,9c77a44d86ac8ac4f2160402709d1710,91-9762274496,32,7,67,74,7,5,12
Malini,Hafiz,Female,14-07-2010,hafiz@yahoo.in,bf231f8310c76e48fa15550b643bfb88,91-9852618938,9,28,87,115,7,3,10
Kanjari,Q,Female,01-05-2008,kanjari_q@yahoo.in,285b053be94cfec1118d284bb0dbf04c,91-9923951937,3,96,5,101,24,32,56
Mridula,X,Female,14-01-2005,mridula_x@gmail.com,4677adff4e8b8372448e9f18b055e678,91-7222597514,36,3,91,94,18,8,26
AENGUS,EWEN,Male,03-01-2009,aengus_762@gmail.com,bc990d61056a22e00de8013635b18084,91-7383735976,49,66,39,105,91,43,134
Thangavel,HUSSAM,Male,15-04-2009,thangavel_hussam@gmail.com,b415ab59aec5454502ab7edfe71a2575,91-9277445234,94,23,54,77,3,53,56
ARLO,UBAIDAH,Male,30-07-2008,arlo_547@yahoo.in,f0e58e0457bd2cd867c1435522ad19bc,91-7178452515,19,99,9,108,33,5,38
Devarpana,C,Male,03-01-2011,devarpana_c_361@gmail.com,37af3808b7ba946172f9455d31c78004,91-8161915946,74,9,2,11,78,46,124
Chitra,K,Female,18-04-2011,chitra@gmail.com,777ec918644c9828ea51a3aad519bab3,91-9414512992,4,44,88,132,45,9,54
Hemlata,A,Female,15-10-2010,hemlata_a@gmail.com,f8e41b840aef25cb2ba1b591b9c5bfd0,91-9425954681,1,4,23,27,9,7,16
Rashmi,RAJA,Female,07-08-2007,rashmi_raja@gmail.com,d817d6dc2b19ddfc6eefed4ab3ed7023,91-7338146972,66,85,78,163,6,1,7
UMAIR,Omswaroop,Male,24-07-2010,umair_omswaroop@gmail.com,e2f9724c3f72244ab5d90845880e7d02,91-7251572583,9,53,7,60,5,8,13
KAVARN,ZACHARY,Male,24-06-2013,kavarn@yahoo.in,8f5f4990f238d153ce755ee4da10856a,91-9618764694,39,6,77,83,5,4,9
Vipasa,ERNEST,Female,02-01-2006,ernest@gmail.com,1a27dca01e73516dd293b1fc77e28e5f,91-8727125589,2,7,51,58,46,6,52
LOHAN,J,Male,29-08-2008,lohan_j_246@yahoo.in,49d9b100cd78e982d2feb086e06de93f,91-7594396252,6,2,97,99,9,2,11
HENRIK,Y,Male,27-01-2007,henrik_y_732@gmail.com,63d54fcc9fae7d4dd0e1ad494ece6ed5,91-7489252166,22,5,69,74,47,31,78
Treya,Z,Female,20-10-2012,treya_967@yahoo.in,a36099cd4cfc8756c9272500690ddf99,NA,0,0,0,0,0,0,0
Shalin,Sohail,Female,15-06-2007,shalin@yahoo.in,e39dc0b98f9b2c7a2190a563e022c6b8,91-9766959224,3,9,77,86,65,44,109
ANDI,CAIN,Male,24-04-2006,andi@gmail.com,1651a2026dd249c14ec22419e0e91987,NA,0,0,0,0,0,0,0
Vindhya,SAMARTH,Female,09-10-2008,vindhya_samarth@gmail.com,e91eb9048c607fa5aab72a74afbb30e0,91-9664768546,15,92,6,98,72,3,75
XZAVIER,H,Male,08-02-2014,h@gmail.com,f5e610a871749b8f0e53ebe12d6c5bde,NA,0,0,0,0,0,0,0
Shravani,J,Female,21-09-2005,shravani_j@gmail.com,e007d59c6b0035b7cc6f5d5c5dafcbc4,91-7245598722,76,6,5,11,8,5,13
Gulab,RAFAN,Female,23-10-2011,rafan@gmail.com,3799953033df2e718e78d485c01bef77,NA,0,0,0,0,0,0,0
FREDDI,P,Male,23-08-2011,freddi_621@gmail.com,ed2c2d9678d6f517069e84dfd8a9f727,91-8246418692,4,99,44,143,91,8,99
Maya,O,Female,23-01-2005,maya_o_685@gmail.com,7ee48b923d84a8fce90e42d4ebd7fbc0,91-8759434163,68,89,7,96,87,8,95
Noopur,VIHAN,Female,14-03-2012,noopur_vihan_564@gmail.com,24877728148e004b29f99de426047194,91-7462569415,9,34,48,82,2,42,44
BRAX,Vrishin,Male,28-02-2007,brax_948@gmail.com,f9a57781f4b6bf52778234c8f816c434,NA,0,0,0,0,0,0,0
Suranjan,L,Male,23-07-2008,suranjan_l_659@gmail.com,e4dc8d1308bbb156ffced8c6a58af50f,91-8133662987,41,3,75,78,49,57,106
ZEYN,Chandrashekar,Male,05-05-2012,zeyn_chandrashekar_694@gmail.com,457affd6492cf7e578abc0adfd1c65ad,91-7236436552,8,5,5,10,6,4,10
Lalana,RABAH,Female,13-03-2014,lalana_rabah_254@yahoo.in,e4b1495790ac4920e3e30ab88093d2b7,91-7769485245,67,51,84,135,39,47,86
Deshna,H,Female,20-02-2013,deshna_h@gmail.com,0a81945b4567f94428d94a3cb7feb65d,91-7494518197,98,83,12,95,26,7,33
Yudhisthir,X,Male,26-11-2006,yudhisthir@gmail.com,2ebed38d1e0fc38cfec2b9d2ca7c8042,91-8157665714,28,23,2,25,68,5,73
Saurabh,J,Male,2011-2-29,j_514@gmail.com,2cecbe3d99c8ae9e826b6c64ce867e26,91-7937167435,42,25,5,30,14,75,89
OCEAN,X,Male,20-08-2011,ocean_x@gmail.com,126d77ac541734758bb43ed716fd4f1d,91-8527293126,3,1,71,72,1,9,10
Rehmat,Yajnarup,Male,18-06-2006,rehmat_894@yahoo.in,d7e6198f2f46d09b0ed2bf920d56861c,NA,0,0,0,0,0,0,0
Mahanth,Kathith,Male,09-01-2010,mahanth_kathith@yahoo.in,636402756a26aa4974fbd05dc2d9463b,91-7179344528,35,94,2,96,79,7,86
ORIN,C,Male,12-05-2011,orin_543@yahoo.in,0fa8c037aacd5e50ed4ccbebd00a35eb,91-9314377391,34,76,2,78,7,22,29
Deepanwita,IVAN,Female,2010-0-7,deepanwita@gmail.com,f2111c574aea220d0891f0002f243920,91-7466898498,2,5,3,8,6,6,12
Rameshwari,Vrishin,Female,2013-0-8,vrishin_361@yahoo.in,780a921b28b60e9555eba303a2f53523,91-7649767523,3,4,9,13,2,28,30
Renuka,Mannath,Female,13-03-2011,renuka@yahoo.in,c82464b2514d78b9ac29d40b69297366,91-9514619161,4,4,7,11,5,51,56
Jaladhi,ZABIAN,Female,19-04-2004,zabian_396@yahoo.in,6c579d4947ebb61ff8b48e8ad691f964,91-8323186373,34,6,75,81,29,41,70
OLIVER-JAY,F,Male,17-10-2013,oliver-jay_f_781@gmail.com,60d0d49b2b4420ec17f24b0ecd402c80,91-7269318475,6,37,1,38,7,6,13
Sartaj,FABIEN,Male,04-01-2012,fabien@gmail.com,b0233b08bfa2537303102a7fccacdabb,91-7791263874,44,82,4,86,36,91,127
SUFYAAN,KHIZER,Male,12-01-2005,sufyaan@gmail.com,9615e323453adb2a4fdc7d068257d493,91-9525327894,74,82,75,157,33,76,109
GABRIELS,P,Male,16-10-2014,gabriels_p@gmail.com,49ac768a80180b644af688e3db84dee6,91-8384214253,5,7,83,90,48,24,72
Tarik,LINAS,Male,2011-0-31,linas@yahoo.in,b7c8d4ecb7cc14c135b6edda1626e58b,NA,0,0,0,0,0,0,0
HAMSA,I,Male,03-06-2009,hamsa_247@yahoo.in,f1a47f763d5d76dc7d73e611854efbf4,91-7872673639,2,9,63,72,45,14,59
Juily,KORAY,Female,10-06-2012,juily_koray@gmail.com,9ac748977f5ebd2adbe77ece5b46f2c1,91-8619371279,2,92,91,183,3,2,5
STEVIE,BASIL,Male,25-01-2007,stevie_basil@gmail.com,afffd0ec71067f980fa0202a41420390,91-7799747934,97,72,93,165,8,41,49
Lona,Itish,Female,04-06-2006,lona_itish_836@yahoo.in,475041b70ef358b3c6ec8a88ebd2a98b,91-7549141774,57,9,14,23,1,9,10
Dev,MAX,Male,21-08-2008,max_682@gmail.com,d282d03a0034254376db9afe065145ce,91-7756338247,2,64,9,73,4,79,83
Vaijayanti,V,Female,13-08-2006,vaijayanti@yahoo.in,ec1a920dd2b0082d10919d86165ed42f,91-9917515414,61,89,65,154,2,8,10
Jyotika,Devnarayan,Female,23-07-2004,jyotika_devnarayan@gmail.com,31eb62fd35a39311f647d1981f11925a,91-8111922513,35,49,74,123,4,47,51
Sacchidananda,HAARITH,Male,14-11-2011,sacchidananda_haarith@gmail.com,d952073bde94f1e3275c7377eb69a57d,91-9742662678,83,58,8,66,68,7,75
Satyavrat,W,Male,08-05-2006,satyavrat_w_541@gmail.com,f70973ed067eece786d451850487afcb,91-8672678937,74,83,7,90,46,9,55
Asvika,Agastior Agastya ,Female,29-08-2009,asvika_491@gmail.com,c87b1558eff6a19ae975c32661b34be3,91-7933873415,61,9,84,93,2,41,43
Anjalika,I,Female,01-11-2006,anjalika_i_283@gmail.com,78d6000965d6e94c298347575968e9c5,91-7637231891,91,43,53,96,48,5,53
Vasu,CAELEB,Male,27-06-2012,vasu_caeleb@gmail.com,43ef7fb755e9a2bd7f19efaf01dc6070,91-9764392365,85,46,2,48,21,6,27
QUINN,DEEP,Male,06-03-2010,quinn_542@yahoo.in,dc7752efb9a1e3a10275c2b6a5ea3b38,91-8119514146,8,8,2,10,99,24,123
CHIRAG,SHAKIB,Male,07-10-2006,chirag_shakib@gmail.com,be61a773671db8965bd43d5d98595872,91-8934218522,9,79,5,84,33,5,38
MALVIN,Pranjivan,Male,01-02-2013,pranjivan_396@gmail.com,7c771871a4fb034fad4db65dde2f107d,91-8751941557,23,29,19,48,35,47,82
Shrivatsa,E,Male,05-10-2013,shrivatsa_819@gmail.com,7497db85f8d3555987a05108df2ba184,91-7493151549,87,99,78,177,7,91,98
ZICO,Padmanabh,Male,13-05-2013,zico_padmanabh@gmail.com,25f915c914767df6a4effbb97f61cd6d,NA,0,0,0,0,0,0,0
Ajitesh,Z,Male,28-02-2006,ajitesh_z@gmail.com,140ea8f2cee87d700e759a83177ec2ae,91-9614528411,24,65,5,70,51,63,114
AKHIL,E,Male,24-11-2013,akhil_e_851@gmail.com,eb0bd970993f5100a948197af2ee1dcf,NA,0,0,0,0,0,0,0
Visala,A,Female,18-06-2007,visala_a@gmail.com,97c61b4e0ccf1d9677d895cbc85dc196,91-7257986912,65,94,1,95,23,44,67
Soumil,CAELUM,Male,13-03-2005,caelum_391@yahoo.in,bdf23c405bf30c13fb5994d907f279ff,91-8738186114,1,89,4,93,42,4,46
Vikesh,Souren,Male,06-02-2012,souren@gmail.com,f48cb45cdddbd7347b07a4f18cf5ca29,91-8727315731,5,9,6,15,92,78,170
Raviprabha,V,Female,27-05-2012,raviprabha_978@gmail.com,76ab7653619ae30e984a8901c6f9452e,91-8868198145,77,8,93,101,2,57,59
Dhikshit,KAUAN,Male,2007-0-19,dhikshit_kauan@yahoo.in,270f6a7415244a745e5a84d4534c7ca8,91-7422744574,7,39,54,93,4,1,5
Samika,S,Female,17-04-2007,samika_615@gmail.com,a2abf97d056ec77051147405aa2aedc7,91-7182798874,9,29,9,38,42,29,71
Yaalini,Kamadev,Female,13-10-2007,kamadev_932@yahoo.in,5f449e79726657004e322bc3de570b4b,91-7176611816,6,24,7,31,47,8,55
Manitha,UNAYS,Female,12-10-2005,manitha_unays_125@yahoo.in,29d838a07f608ade1da95422db61057f,91-8328847325,63,29,79,108,92,3,95
Ilavalagi,D,Female,06-11-2006,d_486@gmail.com,c3505e9f8119d9f895143d77acc1258d,91-7589455279,38,47,9,56,65,81,146
Gayak,Nityasundar,Male,29-01-2008,gayak_nityasundar@yahoo.in,5c94c34e03ae4e1230ef6d654e33ff52,NA,0,0,0,0,0,0,0
DENLEY,HARESH,Male,17-11-2011,haresh@gmail.com,d7f6b856fe91b262b181ecdc80bbe151,91-7649379891,4,11,1,12,9,22,31
Madhu,WEN,Female,04-11-2006,madhu_wen@gmail.com,c04ad7319c211e9af6394f02d8be4cd5,91-9924343365,34,87,5,92,44,5,49
Narmad,Subash,Male,13-09-2007,narmad_subash@yahoo.in,f3e4df8eae76b9bf1e80c22c9746cb9d,91-8252687346,1,8,3,11,67,55,122
CAELEB,F,Male,04-02-2014,caeleb@yahoo.in,a8ce4fcfa7b7de9fef038dcffc9c6496,91-7976532947,9,71,9,80,8,84,92
BAXTER,ABEL,Male,30-11-2006,abel_758@gmail.com,6bbe194e336a29e0e0fc78584d72b11e,NA,0,0,0,0,0,0,0
Prema,Ramith,Female,06-04-2005,ramith_174@gmail.com,a216017c151b217ae36e2b8b24dee551,91-7813496473,4,31,36,67,7,43,50
Abhaya,DEAKON,Female,23-06-2008,deakon@gmail.com,a03e2e2476d1e7c87508cb8f999ea42a,91-7952928195,64,9,84,93,18,8,26
Vilas,THOMAS-JOHN,Male,21-11-2008,thomas-john_236@gmail.com,001ee2daa5dd39be94518dc7d9f6eba4,NA,0,0,0,0,0,0,0
Suvarnarekha,W,Female,2010-0-31,suvarnarekha_w_142@gmail.com,3c3548ed216cb538bc22a79516a71f26,91-7361967426,95,73,1,74,1,16,17
Adrija,T,Female,27-06-2013,adrija_t_137@gmail.com,0ba193029167330af19a9e5ee7aecb5d,NA,0,0,0,0,0,0,0
ALPER,D,Male,2008-0-15,d_248@gmail.com,ab032ed92f0f4f4ce7269e3d48b6eb57,NA,0,0,0,0,0,0,0
Jagjeevan,M,Male,15-10-2013,m@gmail.com,c6b427defc4b9878021e47e7b6c0dca5,NA,0,0,0,0,0,0,0
Saroja,B,Female,11-06-2014,saroja@yahoo.in,1c1d99528fe2930a21d7fe8eb4a459d6,91-9135141171,71,4,2,6,42,88,130
SHARIF,RAHEEL,Male,15-07-2004,sharif_743@yahoo.in,cbb92b21d09eb72e52f9b1c09859a8b1,91-9433398382,4,7,6,13,8,18,26
ANEES,I,Male,07-01-2012,anees@gmail.com,0da977ed4f842a5eb799fb66a8249519,91-9114753526,95,56,5,61,76,47,123
Padmini,EKAMPREET,Female,05-08-2006,padmini_ekampreet@yahoo.in,39903031f75bb64159686c20a6ab2968,91-7947515471,2,2,7,9,2,28,30
Rakhi,KYRELL,Female,25-03-2011,rakhi@gmail.com,fc648bf4c84925721fc4d84555466f86,91-7491652272,1,9,6,15,27,6,33
ZAYNE,LOGEN,Male,07-03-2004,zayne_logen_582@gmail.com,52022610a4594eb62717951437d14b4e,91-8512521753,7,12,78,90,6,33,39
Priyaranjan,Z,Male,07-11-2011,z_657@gmail.com,1aafffe631562680133fbc53b13c27a1,91-9997972568,1,4,6,10,6,77,83
Induleksh,P,Female,05-02-2013,induleksh_p@gmail.com,54f69984d304beae8a5ec1b424570777,91-7498857764,5,43,49,92,74,5,79
TARANVIR,AARYA,Male,01-07-2011,taranvir_aarya_548@gmail.com,d0ad6851a49f2fea57476b72435c7001,91-8286356419,46,3,84,87,95,45,140
Surekha,RONALD,Female,27-02-2008,surekha_ronald@gmail.com,7175c40ee11c76896c9dd04bd940bdae,91-7875582516,2,15,3,18,56,7,63
RYAN-JAMES,B,Male,20-04-2012,ryan-james_b_298@yahoo.in,5a36b16a7984625cf364ca33abc6ec88,91-7363912818,5,5,96,101,89,8,97
Manjula,J,Female,21-01-2007,manjula_831@gmail.com,a853d1b00a4ba6b793ae734ef505d561,91-8945326241,92,82,22,104,8,5,13
Shabana,KACI,Female,09-06-2009,shabana_kaci_578@gmail.com,178218580db08f10f7950630292c0386,91-8997645948,32,29,4,33,15,19,34
Mrudu,Indrasena,Female,24-06-2005,mrudu_275@gmail.com,a47e780c2ef8c74183695d0b8c55e3e2,91-9673918359,15,3,1,4,2,7,9
Vajra,M,Male,2014-0-24,vajra_m@yahoo.in,430c754b965f8915815deb5c2d6123d0,91-7735983525,47,6,44,50,9,2,11
Poorvi,ISMAIL,Female,2008-11-31,poorvi_ismail@gmail.com,a9e5c59fe2121844275c8c5b9c2bdc95,91-8368756574,3,7,24,31,57,4,61
Pallavi,JOBY,Female,01-04-2006,pallavi_joby_546@yahoo.in,c38f5fa6612233068cb667cb7f66d6bf,91-8882643546,8,8,5,13,78,93,171
Amulya,Kanal,Female,17-01-2007,amulya_kanal_157@gmail.com,09413336a28b8324df618a4264666930,91-7918724255,21,2,44,46,55,5,60
Karnik,BARNES,Male,03-11-2006,karnik_barnes@gmail.com,7fe01a8e796c0ef4a56a976be0778472,91-8239328962,45,3,88,91,29,4,33
Amiya,T,Male,15-05-2005,amiya_t@gmail.com,f1254800dff2abf64bf5acf186f249eb,91-7318277867,6,81,79,160,3,1,4
Anuga,C,Female,16-02-2013,anuga@gmail.com,3a6dee35384e313c44e21172dfe49b1c,91-8574967157,55,3,7,10,46,71,117
Vishnupriya,ELIE,Female,2006-0-17,elie@gmail.com,f4c1b65f4a3f6ad8a61e65cf73784b71,91-7313524223,7,3,81,84,59,86,145
Lipika,Shuddhashil,Female,17-04-2011,lipika_512@gmail.com,9c18490f766c76aaae520d736e26aedd,91-9857315292,7,4,37,41,94,4,98
JAYJAY,GAGANDEEP,Male,14-08-2008,jayjay@gmail.com,b1e8ab0a0b7801670d1a43c67e7d7e5b,91-9735792826,7,23,9,32,63,42,105
SAUD,H,Male,30-04-2005,saud_h@gmail.com,287771db17a11e34b71f6fa28f27c3d6,91-7697331646,8,3,5,8,8,14,22
Jalahasini,CAEDEN,Female,04-05-2007,caeden_932@yahoo.in,04aa8224eaee66a8b59255bbc8927389,NA,0,0,0,0,0,0,0
Jalaja,Z,Female,24-02-2008,jalaja_z@gmail.com,ccab5fa372c74e25ac873d38905a0081,NA,0,0,0,0,0,0,0
Agrima,Angada,Female,07-01-2006,agrima_634@gmail.com,e010bbea8092896e80073daae5f2c594,91-9334823718,9,9,6,15,1,2,3
ENZI,BROOK,Male,17-11-2014,brook_781@yahoo.in,54f64a1626c1bbcd6a9e6c6caccc3bb6,91-7732673393,58,28,9,37,45,79,124
Taru,B,Female,31-07-2004,taru_b@gmail.com,6dfcc2af98694371afd16cb6dea3ce8f,91-7591729236,3,2,21,23,9,31,40
Sai,BILAAL,Female,2008-0-3,sai_bilaal@yahoo.in,570127d4440cabcc9ef6f3483ab5908c,91-8973683742,41,3,15,18,56,42,98
Adishree,Chellamani,Female,28-03-2009,chellamani@yahoo.in,4b1bf94d1f416ba61841a50cb7cb0f6e,91-7669692597,8,48,6,54,5,69,74
Angana,MUDASIR,Female,03-06-2008,angana_mudasir@yahoo.in,0bfd69b4f7badcde82b40ab25f36f335,91-7585917185,64,23,76,99,78,84,162
Malika,MIROSLAV,Female,21-04-2007,malika@gmail.com,1ecd47b6181d318fb0b5b3024cd7f8c4,91-9973748535,67,9,52,61,41,66,107
Narayani,S,Female,10-04-2005,narayani_s_453@gmail.com,3864112ab3e929aa2f67eed68eee50ea,91-9194325446,8,4,8,12,3,2,5
ISHER,I,Male,01-05-2009,isher_i@gmail.com,ce21812c4ed6232673d20958de180525,91-8399844721,57,16,68,84,15,6,21
Lily,K,Female,19-03-2009,lily_k@yahoo.in,b201543ebc5b1abb2267410dc8bfdec6,91-7329899616,24,29,47,76,82,1,83
Kanya,I,Female,23-05-2008,kanya@gmail.com,ea3e392b257a474d9e7eb59a6778480d,NA,0,0,0,0,0,0,0
Mohnish,Poojan,Male,05-08-2010,mohnish@gmail.com,2edb8c018f749177f9ee618190a6a861,91-7838958522,61,75,99,174,45,47,92
HENDERSON,YITZCHAK,Male,08-04-2005,henderson@yahoo.in,dcc56252dcf374159c8a460d172bff69,91-7414982188,3,42,39,81,45,11,56
Madhumita,D,Female,15-06-2005,d_283@gmail.com,59a35843ec9a3fe0444fef4acf798708,91-9911265944,54,5,4,9,85,7,92
Champabati,ARION,Female,2011-0-28,champabati@yahoo.in,9e767be362a0c41c06c34ae7b0eb624d,91-9926723773,25,7,1,8,82,91,173
INIGO,O,Male,16-02-2008,inigo_o@yahoo.in,f6b66b9d97c7aa25368366ba823f3a7d,91-8431332266,9,3,4,7,64,1,65
RUSSEL,G,Male,04-10-2008,russel@gmail.com,be3d85c81034ad88d2a69e3e3521476d,91-7737122625,46,2,98,100,16,33,49
KYRELL,TAFHEEM,Male,25-03-2008,tafheem@gmail.com,3bd54b65dddb92078135de05d498bf25,91-8836792127,57,9,7,16,2,7,9
Dhanashri,BARON,Female,26-03-2012,baron_436@gmail.com,06aa4e389514abcd31d7591d555a9978,91-9288765362,83,55,5,60,33,8,41
Kanmani,SAMRAJ,Female,2009-0-22,kanmani_samraj@gmail.com,d1aaccf0dbf16fd78699c3126a40ccd4,91-7283916728,1,1,73,74,68,9,77
Hiranya,D,Female,25-07-2011,d@gmail.com,843fb19cf33f373e987959c414116c51,91-7878499767,56,51,56,107,1,4,5
RIYAZ,P,Male,29-11-2011,riyaz_p@gmail.com,3053ad36c67572bf17db7595864d8fb5,NA,0,0,0,0,0,0,0
JASDEEP,C,Male,14-02-2004,jasdeep_c_897@gmail.com,e3d0f364ce9d11676011b3dbe1df11c0,91-8165149673,1,1,12,13,6,4,10
Anavi,C,Female,09-01-2011,anavi_c_179@gmail.com,03971ff3f3464a49fa12184a346bef3b,91-7553597119,1,48,8,56,3,56,59
YOUSIF,ALEXANDRO,Male,28-06-2011,alexandro@gmail.com,af5934e59b2f2aba950d17f8f8d7963d,91-7761647372,9,1,9,10,8,6,14
RALPHIE,Z,Male,21-09-2010,ralphie_z_372@gmail.com,f48be12b3117160b3dd0c2118bdf7f09,91-8152827567,65,3,5,8,1,5,6
Ekavali,R,Female,11-11-2010,ekavali_274@gmail.com,de469c1aa4b7a22d73b8204a80418086,NA,0,0,0,0,0,0,0
Esha,S,Female,20-07-2009,esha_s@gmail.com,32dccc72c6646422b912359bc87d0c92,91-7329127546,85,9,5,14,27,68,95
Kaustav,Himachal,Male,17-10-2008,himachal@yahoo.in,8adf37b9113e4214fbef839b33ca745d,91-7879957377,79,92,84,176,5,11,16
Prashanti,M,Female,22-10-2011,m@gmail.com,0d7d59dcf4a3e913df723e0ac3fd3098,91-9779237916,21,35,77,112,46,8,54
PRABHNOOR,LAIGHTON,Male,23-07-2004,prabhnoor_laighton_125@gmail.com,cca7afe51e9ce162fd1bc5aa40349721,91-9311172989,27,34,65,99,44,94,138
Alhad,NORBERT,Male,09-01-2005,alhad_norbert_758@yahoo.in,9475edd5ee370e71b5dd3d149f0ba4ee,91-7874112726,3,6,9,15,32,64,96
LONG,TEJ,Male,30-10-2010,long_tej_275@gmail.com,7cb0740248d7f08114a6dd19ca04eb41,91-7974888416,33,24,1,25,8,3,11
Tejashree,Bhagaditya,Female,16-02-2011,tejashree_bhagaditya_816@gmail.com,fd3659c989bd1acd4b1c98d4744ce4fd,91-8427983841,74,45,7,52,9,8,17
Tula,Premanand,Male,11-01-2009,premanand@gmail.com,3b71a96551c9f78b3a18bb9ef025bfcd,91-7443292973,46,38,84,122,15,74,89
Bindiya,B,Female,03-07-2008,bindiya@gmail.com,c89154ba3c931d4414586e24e3bb0d60,91-7598451273,8,26,9,35,67,46,113
Sarjana,L,Female,2005-0-3,sarjana_l@gmail.com,cafc787a1e11cf921459d6cc5f187f2a,NA,0,0,0,0,0,0,0
TANZEEL,PHILIPPE,Male,06-10-2010,tanzeel@gmail.com,631887010c69e6ad5818fa91d6e88e7f,91-7222233296,16,3,55,58,7,2,9
Thenappan,MUBASHIR,Male,16-02-2008,thenappan_587@gmail.com,823efad747e361387e2efe13f16e382d,91-9454489547,5,79,71,150,36,6,42
MIKAEL,Sartaj,Male,23-06-2012,mikael@gmail.com,45bf5a66a50bda0f178220f0e802240b,NA,0,0,0,0,0,0,0
Satyarupa,I,Female,2011-0-22,satyarupa_i@yahoo.in,66d76975c11b4ca3c930296a92cd2995,NA,0,0,0,0,0,0,0
Pratigya,E,Female,30-10-2013,pratigya@gmail.com,0981c32179a8358a5df8b59be0263afb,91-8434131957,2,1,92,93,2,91,93
FREDRIK,G,Male,2005-0-26,fredrik_g@gmail.com,795b9ad2ecd6fafad592f69bdc976323,91-7943595949,85,4,3,7,8,23,31
Shantala,MANISH,Female,14-02-2008,manish@gmail.com,0ea95ef9dd3d96ac08ecac7215c9e95a,91-8275289596,78,6,8,14,1,6,7
ALBIN,N,Male,17-04-2009,albin_n_932@yahoo.in,f9896af14c017c425fb88172a8783448,91-9674435996,32,2,7,9,48,5,53
Chhaya,N,Female,17-09-2008,chhaya@gmail.com,f84c1368f8f1197b4c27aa74f56b9971,91-9838354185,69,3,89,92,8,2,10
Sutapa,Nadir,Female,2009-0-4,sutapa_nadir@gmail.com,739a28650f4daf71d7cc568e8be06b2d,91-7998943155,59,99,5,104,3,49,52
BRONSON,Z,Male,06-05-2007,bronson@gmail.com,739bf3c74d560f2410d30fc928f6570b,91-8777649547,8,76,7,83,6,4,10
Radheya,Deepit,Male,08-07-2009,radheya_967@gmail.com,73671d5b65a33b839911aa68c9610dca,NA,0,0,0,0,0,0,0
Heera,D,Female,16-06-2008,heera@gmail.com,d7f58c656cb4f8cfd855fb83d6f9b8b3,91-7332472539,4,84,3,87,44,49,93
Suvarnaprabha,M,Female,2011-0-8,m_762@gmail.com,b5a7cea1f9ef6ea5c6790e9e4ab23e0f,91-7364891726,1,4,51,55,8,2,10
Vinaya,Z,Female,17-02-2014,vinaya_124@gmail.com,2432b43be1f5062095365886ee383d85,91-7484471868,95,59,2,61,68,57,125
Gopa,Bhagaditya,Female,09-10-2012,gopa@gmail.com,d9def918c116543ee12909215f3778d1,91-7528622415,3,9,81,90,7,54,61
Sumati,W,Female,28-09-2011,sumati_w@gmail.com,e498ef20029fc890fd70e917d7590be8,91-8637833497,6,8,1,9,6,21,27
Elili,Q,Female,13-01-2013,elili_836@gmail.com,2d17b2b8af5ec703d8cc70c375f3c388,91-8653575289,51,6,32,38,2,89,91
Manjubala,N,Female,21-10-2006,manjubala_n@gmail.com,4bffc4a78671c732887742313132e816,91-7561261153,67,25,6,31,85,3,88
DAWSON,R,Male,03-05-2005,dawson_526@gmail.com,567987b94ee57dad74eebc8b75acebaa,91-7112344856,56,1,65,66,6,8,14
Fullara,YONG,Female,20-05-2014,fullara_315@yahoo.in,c7b02dce3a794eaa019143eb1c95e9d0,NA,0,0,0,0,0,0,0
ROSCO,P,Male,2014-0-9,rosco_p_382@gmail.com,0c9d0f989423c9b26722c6d362bfa8a9,91-9553293428,3,49,7,56,36,9,45
Acaryanandana,AMAL,Male,19-08-2004,acaryanandana@gmail.com,09c8c2fc356a5256e19e45fa9a774c5b,91-9563591663,84,84,62,146,6,2,8
Asgar,MALAKAI,Male,22-06-2009,asgar_malakai_519@gmail.com,6677fdc9e4a43e9d33c0de539a6ceab5,NA,0,0,0,0,0,0,0
Sameena,C,Female,30-07-2005,sameena_c_893@yahoo.in,336f13c515e26f2ec6e506143bb5c335,91-7569195596,1,75,2,77,55,1,56
Vahini,S,Female,04-10-2005,s@gmail.com,b566a9b0b2c15d423798902fe19119f1,91-8335886344,3,3,5,8,1,2,3
Charitra,JONA,Female,22-07-2013,charitra_jona@gmail.com,984667323b450a1dc02150cb2bd5f5e4,91-9553363288,3,11,86,97,59,23,82
Kananbala,R,Female,06-04-2011,kananbala@gmail.com,97b8a6c3bde877352f0a25af73f6a8c4,91-7874657973,63,1,22,23,5,3,8
Devaki,G,Female,03-04-2005,devaki_g@gmail.com,b130e5037727f341275d3aa1983d43c9,91-9144323947,1,5,6,11,29,8,37
DOMINYKAS,Janya,Male,25-09-2004,janya@gmail.com,eccb32b3e4f4634860d45600941083ec,NA,0,0,0,0,0,0,0
ROOP,G,Male,06-01-2012,roop_g_187@gmail.com,e6457f2d673e6437eef80b42a5f02b8b,NA,0,0,0,0,0,0,0
Samit,ZYAN,Female,01-07-2005,samit_zyan_187@gmail.com,0c8feb1e4e51797f747ccdbd37d72a94,91-7868191129,36,3,1,4,14,9,23
Mukti,K,Female,06-03-2010,mukti_k@yahoo.in,fe9bb82d6c91d5da5f434d1e8d6a9475,91-7353669984,1,3,36,39,69,62,131
Lipi,JOKUBAS,Female,28-02-2010,lipi@gmail.com,d7b4278f46d87bf1b72d4a08ca7ddc65,91-7517792891,2,22,5,27,8,78,86
NAYEF,D,Male,29-05-2011,d@gmail.com,5ba67e5aba2a80832bbdb03fd409d740,NA,0,0,0,0,0,0,0
RODI,F,Male,26-01-2009,f@gmail.com,ba9694a4e04e5b8bd70d7b8c9c27c469,91-7217816955,31,7,5,12,9,5,14
FABRICIO,T,Male,23-10-2014,fabricio_t_526@yahoo.in,c7fdc8fbda179826e8c24638c92c2560,NA,0,0,0,0,0,0,0
KHUSHAL,TEON,Male,12-01-2010,khushal_teon_197@yahoo.in,4732f8fd7e3032ca73d05f207451316f,91-8637992726,97,95,1,96,96,89,185
JULIUSZ,FREDERICK,Male,19-04-2010,frederick@gmail.com,b9d3412fe917ecab34547fb3092de4a1,91-9455115653,5,7,89,96,7,35,42
Archana,KISHAN,Female,25-04-2005,archana_kishan_325@gmail.com,6d3e3e2b754d499081395594aa6d02ae,91-9455697831,78,8,52,60,8,43,51
Ela,Purnanada,Female,2005-0-13,ela_purnanada@gmail.com,cc12b3bce507d779f6a8a3635487732c,91-7235924792,6,14,29,43,95,93,188
SIMEON,HARLEE,Male,08-03-2008,simeon@yahoo.in,849bb77c228b7c05143b99814cae7d01,NA,0,0,0,0,0,0,0
MEKHI,DEREK,Male,17-08-2004,mekhi_derek@gmail.com,b5591f6d44fe78921812d57dce46fb65,91-7499663938,85,56,8,64,36,7,43
EMILIJUS,A,Male,24-04-2009,emilijus_a@gmail.com,4e99faeae2bebb4743f56516d70198af,91-7663487133,4,85,37,122,7,56,63
KIEL,Ajatashatru,Male,27-08-2009,ajatashatru_841@yahoo.in,9e4a85f4a31c59a4eb589e1b531b6489,91-7195557942,1,2,95,97,13,4,17
JAYDEN-LEE,ROMAR,Male,19-09-2008,jayden-lee@gmail.com,109a952dfc8e34aade0e47b0c053fcea,91-8829992987,66,34,5,39,82,13,95
Divena,S,Female,21-07-2006,divena_s@gmail.com,c4a264dc4edd4d3dd2b16bce896337a2,91-9523598738,1,2,12,14,8,4,12
Mitali,TODD,Female,19-02-2005,mitali_todd_386@gmail.com,7a178c1e34bcad063cba307c492e0fcb,NA,0,0,0,0,0,0,0
Ayyapan,Dyutit,Male,14-02-2005,dyutit_124@gmail.com,ef90ae02e0fa6fb58d463acb1a94ab7b,91-7259546992,8,81,3,84,65,74,139
Jalendu,V,Male,20-02-2011,v_315@gmail.com,da5b4599769cd143877faaa940906f55,91-9554836667,6,4,32,36,2,6,8
Meghana,DOUGIE,Female,12-07-2007,meghana@gmail.com,9479c09473d15c14ff6b3480b58a9f0b,NA,0,0,0,0,0,0,0
HOLDEN,C,Male,01-06-2005,holden_c_531@yahoo.in,4e91d8e637a72d6ce4f6f7aae8097997,91-7661713395,6,93,52,145,96,5,101
Siddhima,U,Female,26-04-2009,siddhima_289@gmail.com,c562cf10a78270dbb758e854016029e6,91-9711225998,41,2,71,73,1,25,26
Deepashikha,F,Female,11-07-2005,deepashikha_985@yahoo.in,dbccdadc5d3cde542ecce653d4087ea2,91-7592471681,53,37,87,124,73,6,79
Shridevi,D,Female,06-11-2008,shridevi_d@gmail.com,12f41c0d3f5023b0e3de49effcc3578e,91-7947246915,6,14,96,110,95,12,107
Subhan,E,Male,21-11-2006,subhan@gmail.com,481a3ba2bee8078080782de2e06a0a4d,91-8563113885,9,93,26,119,7,8,15
YUKI,CHIKE,Male,15-09-2004,yuki@gmail.com,0dc2e9cfa7776cc4115e06b5a337e751,91-8937371277,28,75,8,83,45,55,100
Pragati,M,Female,20-08-2010,pragati_718@gmail.com,b962ddace57297c63177970d19d26d7c,91-9263154982,76,9,48,57,76,8,84
ADIL,SHILOH,Male,23-10-2008,adil_947@gmail.com,13b2d41494dd166a221db87f116a55e8,NA,0,0,0,0,0,0,0
Tejaswi,R,Female,25-08-2008,tejaswi_r_294@yahoo.in,9e41b2976a57b6fbdc420ccece954b79,91-7634393237,68,4,98,102,8,3,11
Amrusha,V,Female,10-04-2009,amrusha_v@gmail.com,820c90d29c43b1834b59694596287e00,91-7891817664,8,22,97,119,5,48,53
Antara,U,Female,19-08-2007,u@gmail.com,536824ee98218b32d3997eb46ce8d158,91-7456849539,8,45,7,52,15,8,23
Neelam,Guru,Female,12-02-2010,neelam@gmail.com,95991669a91f86941c1e4124a578eb5c,NA,0,0,0,0,0,0,0
Udita,L,Female,25-04-2010,udita_l_375@gmail.com,4157a65f278b76e0e5baded178708558,91-7871253455,7,1,71,72,9,41,50
Mahmud,NIKASH,Male,29-08-2013,mahmud_391@yahoo.in,e08809593da871f67966106b48dfad0d,91-7182275191,7,9,89,98,3,86,89
Janitha,TIMOTEI,Female,2010-0-22,janitha_timotei_472@gmail.com,773d0a9114382a24dc4276f5dfe0e61c,91-7212518236,8,87,8,95,2,2,4
ASLAM,M,Male,03-03-2008,m@gmail.com,45561d9e8aa9a5f8c54e3b96a7f140df,91-7938667572,14,32,6,38,48,9,57
TEGHVEER,H,Male,21-05-2005,teghveer_h_834@gmail.com,d5e19bc6f58acb0b72b0b8922080363a,91-8119217128,1,1,3,4,75,7,82
Sarasa,TENNESSEE,Female,18-04-2005,sarasa_tennessee_837@yahoo.in,6bd36201a9ada3a48680c9eb70b6f55e,91-9568877799,3,84,74,158,99,5,104
Manikuntala,Paresh,Female,15-09-2014,manikuntala@gmail.com,2027f69636779aa9e5c5dab7822c712d,NA,0,0,0,0,0,0,0
Kumudini,S,Female,24-07-2004,kumudini_736@gmail.com,9019c16b508981db31e9b194399c6af5,91-7355184423,1,8,9,17,75,1,76
Anokhi,E,Female,27-06-2013,anokhi_e@gmail.com,c36bb35c8dc99a8c872ec178d86adf66,91-7882235681,5,25,3,28,82,25,107
Heera,V,Female,01-08-2007,heera@gmail.com,bffee5516fdba7c9fe757c65eee71749,91-7257744896,6,46,8,54,76,86,162
TOMMY-JOE,Q,Male,02-01-2005,tommy-joe_846@yahoo.in,46843a768360f71a76a354e2eef43ba8,91-7765996468,18,56,79,135,92,97,189
Namita,Y,Female,25-08-2004,namita_841@gmail.com,6f2f94a97696e0a6fbce197e2120b50b,91-7723666732,7,33,4,37,35,9,44
Virata,Y,Female,01-03-2010,virata_y@gmail.com,b56c730e7e138f5493f080136ea1e400,91-7831817862,28,2,37,39,52,99,151
Pavani,KHIAN,Female,18-09-2007,pavani_khian@yahoo.in,bc3ed9ddb1897b76b02e873e96e6a01a,91-9682633964,4,14,6,20,51,5,56
EZRAH,W,Male,19-11-2005,ezrah_w@gmail.com,815b7d3cea14a67a8e15fbc522b626da,91-7298955619,7,41,4,45,6,6,12
Indrayani,VISHAN,Female,25-02-2004,indrayani_967@yahoo.in,bdfee0e7ee22ab7cdbc9e9d6467dc067,NA,0,0,0,0,0,0,0
HENRY-JAMES,C,Male,20-07-2006,henry-james_c@gmail.com,10586d9510274d0cd3c0d7586072a363,91-7181996481,77,97,9,106,22,33,55
Soma,H,Female,10-08-2013,soma_h@gmail.com,7598310708c4e7fd8400c8e4ec92e51c,91-7169737626,2,4,1,5,87,11,98
IKENNA,T,Male,23-04-2012,ikenna_t_547@gmail.com,b313ea93702c94ec6aa8717ef1a2f277,91-7821982865,49,73,2,75,6,9,15
Nagina,BORIS,Female,01-04-2011,nagina_boris@gmail.com,47e363d6e1169fcf42cb2c3c334468f9,91-7889923561,6,57,58,115,5,53,58
Kamakshi,G,Female,02-02-2004,kamakshi_g_824@gmail.com,7095bb11d0bda931412e9babf27baf60,91-8324197566,61,46,64,110,12,1,13
Parnal,HANS,Female,09-01-2006,parnal_hans_249@gmail.com,464cdd5902cecebf2ac4c0adb9d09d9c,91-7137628458,6,85,29,114,1,39,40
Aparijita,J,Female,14-03-2006,aparijita_745@gmail.com,5340e9bc83d06ae8982d7733d0a0d511,91-8595315912,21,5,47,52,28,5,33
IONUT,BROOK,Male,09-06-2008,ionut_brook_741@gmail.com,5bde7f7295b82b5eddcf56ff285afb3d,91-7622718463,4,81,7,88,66,8,74
SHYAM,RAND,Male,2013-0-10,rand_329@gmail.com,8bd50287788e53d642b03256fa41dc26,91-7657759653,6,4,9,13,91,7,98
SHAHIR,LEANDRE,Male,26-11-2007,shahir_leandre@yahoo.in,8d278f80497f3ba41e1bc467fe25a63e,91-7271387655,5,4,2,6,8,3,11
Cauvery,L,Female,09-01-2009,cauvery_l_856@gmail.com,5eaa4080c1221d48ea4cb6ec40bd500d,91-9664984799,6,24,61,85,74,8,82
Mahua,O,Female,09-04-2010,o@gmail.com,e699774d40dc81f14f6c45ff4f8651e9,91-7889391377,3,19,14,33,3,13,16
Janitha,KIRK,Female,14-01-2004,janitha@gmail.com,b6a0d45fb3673af64cdf1118bc6078df,91-7416925176,66,4,6,10,24,4,28
Parni,Anshul,Female,28-05-2006,parni_anshul_894@gmail.com,c59366f7f07424360285960a341cb022,91-7823984746,63,4,5,9,92,67,159
JEREMIASZ,EINAR,Male,2011-0-18,einar@gmail.com,f4480594741645c7a61949f19052b322,91-8458778352,6,5,62,67,18,71,89
Girija,K,Female,27-07-2009,k_851@gmail.com,af4c1299da3d85e2d60046bd4492eac2,91-9336187563,7,86,42,128,6,9,15
Praful,Ramavatar,Male,06-09-2014,ramavatar@gmail.com,cff38727e5c3b728e5ddb8c756df032b,91-7845222266,51,1,63,64,83,23,106
Archa,JAIVIN,Female,22-04-2011,jaivin_281@gmail.com,983016d813c2346225bb03e6c7cf1d7d,91-7271149397,53,5,75,80,8,26,34
Bageshri,M,Female,18-11-2005,bageshri_m@yahoo.in,204942944bbcde2b3a0bf746ef8f48c1,91-8472619465,9,49,8,57,12,9,21
Madhubala,DALEY,Female,2005-0-19,madhubala@gmail.com,ea5a76f258b0b12317b09ff42f49ab16,91-7466482287,32,66,2,68,46,63,109
Rangitha,M,Female,17-03-2008,rangitha_627@gmail.com,125ea508e2146a1d2db45e728693cbb0,91-7467765167,3,87,5,92,93,23,116
Bhumi,NASIF,Male,05-08-2009,bhumi_nasif@gmail.com,05ff2c974b2ad2a69b17bfa375c5651b,91-8335982982,3,54,29,83,5,2,7
Foolanor Phoolan,CODY-LEE,Female,20-07-2009,foolanor phoolan_cody-lee@gmail.com,3e1a734019aaf9131dbb70a99c8ed2a0,91-7787391246,5,77,66,143,33,68,101
AQEEB,ASHDEN,Male,03-09-2006,aqeeb_ashden_675@gmail.com,8d45b6d3219ba88b69ba4643b5d34560,91-8169135799,8,7,2,9,39,6,45
Charuprabha,M,Female,06-04-2013,m_162@gmail.com,34397f5afd2fd71e2b220e667824a3ff,91-8848673951,6,1,6,7,19,56,75
Kakali,Nambi,Female,26-07-2009,kakali_nambi@yahoo.in,75964f94ad95e550e7ebf26729f2d424,91-8868551266,2,2,7,9,4,3,7
Chellamuthu,BENEDIKT,Male,25-11-2004,chellamuthu_benedikt_197@gmail.com,54053fb542a02315ebe727ed80b19d62,91-8267117598,52,25,54,79,64,7,71
Jhinuk,Harinarayan,Female,20-11-2013,jhinuk_harinarayan@gmail.com,de754a8501cb57a34641f88fb84b5be6,NA,0,0,0,0,0,0,0
RIZWAN,Hariom,Male,11-06-2013,rizwan_hariom_521@yahoo.in,588181ef813329665ddc5bf5d5c1635e,NA,0,0,0,0,0,0,0
LEART,X,Male,25-08-2007,leart_x_863@gmail.com,dd3ba3c2f0244eab0940ebe4c9d676f0,91-8435541686,98,2,63,65,56,49,105
Radha,D,Female,04-03-2006,radha_d@gmail.com,c9e25a1553aed371594067c14a234284,91-9927683919,46,82,9,91,3,18,21
RHUBEN,YOAN,Male,20-04-2006,rhuben_357@yahoo.in,d76fe4cde7a7f95e07e18d68a0e2dc95,NA,0,0,0,0,0,0,0
Tripti,ROSSI,Female,01-08-2009,rossi_926@gmail.com,d13f271d2402d77875ba521c74ff9007,91-7275818159,95,7,6,13,4,8,12
Shashi,Akhil,Female,07-10-2008,shashi_akhil@gmail.com,59ca805947dd35ab0e3ece58ca303eac,91-7884973292,7,4,2,6,71,6,77
QI,Z,Male,29-04-2009,qi_z_298@gmail.com,e95c64aa4ac86bfcfb7f7a8545b1c227,91-9243652944,53,4,95,99,6,83,89
SHERWIN,H,Male,03-07-2013,sherwin_365@gmail.com,156bbc030fad843d6f65eba630afb4ab,91-7282343783,54,18,8,26,3,3,6
Treya,M,Female,15-11-2013,treya_m@yahoo.in,c3591d00608aa39a12d298dc65ecbfa7,91-7671924758,75,77,3,80,1,39,40
LARSON,SHIVAN,Male,05-02-2006,shivan@gmail.com,0bb696b7e9da41348801af81de3fd166,91-9637142732,8,26,6,32,15,8,23
Dhanishta,ALFI,Female,17-01-2009,alfi_416@gmail.com,b7350f206495c11f741da050d9e38e4a,91-7937663289,8,3,3,6,39,61,100
JESSE-JAMES,SULEIMAN,Male,14-05-2012,suleiman@gmail.com,1d618c993f2afafcf8a131701d109575,NA,0,0,0,0,0,0,0
RAYON,Z,Male,18-06-2006,rayon@gmail.com,ed22b05a33806723efc1582fe185c25f,91-7458887564,5,3,9,12,76,3,79
Rupin,Bhanu,Male,24-04-2005,bhanu@gmail.com,1b933305afc7ae2ec45592e2497a7734,91-8379242454,7,57,5,62,69,1,70
Hridaynath,Dhwani,Male,11-03-2013,hridaynath_421@gmail.com,889adf5b4523b7a9a5368c8ee67a9a94,NA,0,0,0,0,0,0,0
Shyamalika,Ganesh,Female,06-08-2014,shyamalika@gmail.com,def58548405420fa3d7497189ef91889,91-7715943655,66,7,84,91,37,55,92
Mudrika,T,Female,07-06-2011,mudrika_t@gmail.com,dd366bdb177b8a6f8f8d99bd8a82a3dc,NA,0,0,0,0,0,0,0
Shweta,J,Female,30-11-2011,shweta_j_921@gmail.com,adc9f1e7e7deaf5ce9821231c42f4bfc,91-8834976245,6,72,71,143,3,19,22
Chandrahas,Pannalal,Male,18-07-2007,chandrahas_943@gmail.com,92df5c720d0e64f66096697390e7f8cb,91-7861187314,98,7,43,50,4,46,50
Mrinalini,BROOKS,Female,11-02-2013,brooks@yahoo.in,48417c3d8a6cce04a0352a0e3b0b767f,91-8266572525,5,3,5,8,92,65,157
Aishani,Z,Female,09-03-2007,aishani_829@gmail.com,ef305b13ed5c85e1ec83ce78a0baaf79,91-8678433782,59,35,34,69,87,61,148
EFRAIM,KONRAD,Male,24-01-2006,efraim_konrad@gmail.com,a5e31fdd1c2174d0f92686a779d96b8e,91-7553592929,52,5,3,8,42,85,127
Anjum,D,Male,29-02-2012,anjum_269@yahoo.in,ef555f1b415fa8553a5a30a082c4a69b,91-7986332694,74,4,66,70,85,93,178
HIRO,Chanakya,Male,19-11-2013,hiro_916@gmail.com,0beeeecf9048ed2146240f18e405d501,91-7826931638,5,68,2,70,4,72,76
IZAK,I,Male,14-08-2014,izak_i@yahoo.in,1d41bc42c0fad506d7239309a156bd75,91-7613261465,79,9,77,86,6,8,14
Kushala,SEYAR,Female,02-01-2014,kushala_seyar_852@gmail.com,3069922a2fe73897277d46650c616e81,91-8213965356,2,54,26,80,86,64,150
Omala,T,Female,07-10-2010,t_782@gmail.com,b8c994a75739c3319bf682ca89228e56,91-7267124863,8,19,3,22,8,92,100
THABANI,DEE-JAY,Male,30-06-2007,dee-jay_845@gmail.com,f00ed21749ce0df170a5aa9f063a50f6,91-7773473826,14,3,33,36,39,2,41
MALLORY,Pankaj,Male,03-09-2005,mallory_pankaj@yahoo.in,942bac4ecd60e35a9dbb011e185f314a,91-8662719298,23,76,73,149,12,22,34
Savita,MICHAEL-JUNIOR,Female,03-03-2004,savita_michael-junior@gmail.com,7dacc9333efbb470ec39b78e8149bb70,91-7545638781,7,16,9,25,98,6,104
KARANVEER,AGASTYA,Male,2006-0-14,karanveer_agastya_582@gmail.com,568ad1e79b4513d68fdbf6ed0d680daa,91-7516665347,6,4,2,6,46,2,48
Maitreya,S,Male,25-05-2010,maitreya_286@gmail.com,ff0f2cc7923400ff13a6460630686289,91-8849953584,63,3,9,12,2,1,3
Madira,F,Female,16-02-2005,madira_f_267@yahoo.in,b4f382ab4ee1dd748038b9f4b7dfc14a,91-9552549681,6,14,38,52,2,8,10
JAPVEER,Z,Male,26-05-2010,japveer_z@gmail.com,bd2dd3e12d55cf9fa2dd260e2293b176,91-9592488442,32,9,68,77,9,9,18
Prama,DARRAGH,Female,21-01-2007,darragh@yahoo.in,b9a7c59db0ee7e78443d4c96813d40f0,91-7579197728,9,6,2,8,1,9,10
Murad,Devesh,Male,17-09-2009,devesh@gmail.com,c34f42bc472daf8b3cc478d865da3b19,91-8156625431,3,4,78,82,1,6,7
PRANAV,SIYAM,Male,01-09-2010,pranav_siyam@gmail.com,131b44c30d2ab7b271a2cf2a68d8d3b5,91-7427468942,33,6,41,47,14,59,73
Mohana,Q,Female,29-11-2006,mohana_q_869@gmail.com,898de00e72d4d6f5fc566ab29dcd322b,91-9171827419,57,65,38,103,48,68,116
Rohini,L,Female,24-01-2010,rohini@gmail.com,a3304339483ad70b241275d7ca2be2d0,91-7995883697,1,5,6,11,8,23,31
DARIO,N,Male,20-02-2010,dario_n@yahoo.in,482c0c9c113c3bf27d41d740376e6074,91-8844167718,3,19,47,66,9,4,13
GUSTAW,R,Male,24-09-2008,r_619@yahoo.in,a66f9577e5f1b723baeb600add9d8a2b,91-8364218893,14,54,2,56,3,14,17
MATIS,MAXWEL,Male,2009-0-13,maxwel@gmail.com,24dc6f114b83837bbdae37be7d8ce978,91-7168293977,8,33,56,89,34,7,41
Shobha,U,Female,2007-0-10,shobha_u_768@gmail.com,e50514835afb0d3ffc386d7307398d22,91-9397433931,3,71,66,137,6,6,12
AEDEN,S,Male,08-02-2007,aeden_s_316@gmail.com,e4fe93b177d524026230d8e1e1dd40e8,91-9378572555,9,94,3,97,84,9,93
Sonam,Q,Female,01-07-2011,sonam@gmail.com,75c9e7b5f22a85523d336e020e922076,91-7132937693,8,4,1,5,61,6,67
Menitha,DONELL,Female,07-04-2006,menitha@gmail.com,b745dfcd68699b0aad321ef34ee58cd4,91-7151893669,37,61,4,65,95,42,137
Sampriti,R,Female,12-02-2014,r@gmail.com,635a0987d8149d0e752abe643830a852,91-7727522473,46,8,58,66,34,5,39
Manjira,VAKARIS,Female,11-06-2007,vakaris_198@gmail.com,5e060d13e46dc1e259acf60ec294a33f,91-7769944218,9,94,76,170,4,4,8
THEON,BAI,Male,06-02-2007,theon_bai_863@gmail.com,e348d43c8808a9536126c418e3f02ad2,91-7448215423,6,6,9,15,41,1,42
EIDENAS,MEHTAB,Male,06-11-2006,eidenas_217@gmail.com,dcfdfb285d69f0ac55d8935465f6bdfa,91-9614154457,5,1,93,94,1,2,3
ALVI,JAHMAI,Male,23-01-2005,alvi_jahmai@gmail.com,dd210d890bfe8e8a4c8bb2504b17240b,91-8567712522,15,5,85,90,7,61,68
Amari,E,Female,12-02-2005,amari_e@gmail.com,447c04969f52c4f7de138f1cd5cdad79,91-8797484755,23,5,83,88,9,86,95
Shrigopal,MITCHELL,Male,2006-0-12,shrigopal_mitchell_591@gmail.com,2f0fa5c4c839a3df7b8a088078f6e6f1,91-9657792473,9,4,2,6,1,79,80
Seemantini,Y,Female,21-07-2010,seemantini@yahoo.in,c2d94f41d1c84c156ab97abf0151c7cf,91-7897363261,9,4,2,6,47,46,93
Tapati,ALFIE-JAI,Female,17-05-2012,tapati_alfie-jai_157@yahoo.in,358befc6d7411c53178207183376eeda,NA,0,0,0,0,0,0,0
Ramavatar,Jalad,Male,06-09-2012,ramavatar_951@gmail.com,bf4965e089fe47bc3bcede8ce315749b,91-9967641227,9,34,5,39,1,8,9
Bakula,KADIR,Female,04-10-2006,bakula_kadir@gmail.com,a27d48cf59349aa5b0ea52962f40bd7e,91-7424627875,78,85,45,130,6,53,59
LINAS,B,Male,21-07-2005,b_816@yahoo.in,4eb06d0487bc875052f74be002019ea8,91-9857145893,5,46,7,53,5,19,24
Kashi,Devajyoti,Female,28-06-2011,kashi_devajyoti_876@yahoo.in,ec81fd46921b1918ac004cafdb9394e3,91-9991777617,5,46,5,51,4,59,63
Devahuti,G,Female,09-10-2004,g@gmail.com,c7edfbb600dc23b554d1dce69fcc738f,91-7315197451,66,7,1,8,9,2,11
Jayamala,NICK,Female,11-08-2010,jayamala_nick_537@yahoo.in,1986961caef4536e0c37618d58c7b780,91-9211693867,17,6,38,44,27,1,28
Tanmaya,J,Female,01-10-2010,tanmaya_j_527@gmail.com,b9a22196359d7eceab386d1ff2b04b08,91-8293981426,94,8,4,12,56,1,57
Shubhangi,LION,Female,05-02-2006,shubhangi_lion@yahoo.in,c3dd43a0ccf7481ac14bd72c4bef2a2b,91-7329732993,58,6,98,104,2,59,61
Taruni,B,Female,06-08-2005,taruni_b@gmail.com,758040a6d1f3914710b92c2dff8ab969,91-7726552492,83,3,17,20,12,7,19
ENZO,SHIVAM,Male,26-01-2010,enzo_754@gmail.com,d9107a03a15d9ad6f8ae91cfc56ec4af,91-7892462712,36,98,6,104,1,12,13
Urmi,DESMOND,Female,01-08-2007,urmi_desmond_543@gmail.com,32789d2da00379be85eed3d9aedff89d,91-7231566471,8,9,3,12,4,76,80
TEGAN,Y,Male,03-01-2010,tegan@gmail.com,cb8cf808e6681db2b0a3f397dfabdc13,91-7723256178,8,45,6,51,5,14,19
Nirmitha,O,Female,02-03-2011,o@gmail.com,700c893afa19bfcb5233bc70aab2187d,NA,0,0,0,0,0,0,0
Mahalakshmi,TYLA,Female,01-06-2005,mahalakshmi_tyla@yahoo.in,806326d4c6063cc051c0cd2c38d35f63,91-7713317864,25,1,5,6,23,89,112
Kanmani,I,Female,20-11-2005,kanmani_i@gmail.com,666ab752f035df4e0aab7b62105010b3,NA,0,0,0,0,0,0,0
Resham,ANGUS,Female,04-11-2008,resham_972@gmail.com,3a179f69c8c1c9eff343a00dacb0f392,91-7921581622,23,6,6,12,42,2,44
Divena,KAILAN,Female,04-01-2010,kailan_948@yahoo.in,c61163a962cedd3cf1fe4e92584ae08d,91-8427243765,24,34,8,42,3,59,62
Rishika,IYAD,Female,30-04-2013,iyad_243@gmail.com,ac096dc87e2239c6f90a9a4b6e068213,NA,0,0,0,0,0,0,0
OLIVERIS,KURT,Male,04-09-2014,kurt_398@yahoo.in,645f312e42ffdf430b103221875d449b,91-9175731937,12,41,11,52,6,13,19
Cheliyan,SHIVAM,Male,07-11-2011,cheliyan_shivam_974@gmail.com,7816edfff975b1624316e754a9e1575e,91-7818286478,83,66,8,74,5,2,7
GEORGIE,R,Male,15-05-2009,r_864@yahoo.in,c8ef538434a517a3c794f061e9f7b05a,91-7628238255,76,29,73,102,4,62,66
Ashalata,R,Female,10-08-2013,ashalata_r_798@gmail.com,fa7c78432b0a09945d323eaca5bd74d2,91-8463929492,6,7,2,9,73,8,81
Shuchismita,X,Female,07-02-2009,shuchismita_367@gmail.com,716ce85611b14d39ebd5ffe0677570f4,91-7629582924,88,4,1,5,5,7,12
JACKSON-JAMES,Z,Male,23-09-2014,z@gmail.com,9d4d11f470f1afd950d085e2f4271f57,91-7812987431,3,95,3,98,34,24,58
DOVID,M,Male,12-03-2004,m_739@gmail.com,d591b55907a53ad4b957d32c8aeb8a34,91-7628935943,1,89,26,115,5,71,76
Harsha,V,Male,26-10-2007,harsha_v_286@yahoo.in,e462bc5e86634ccfe893f6584380bfed,91-8731129672,8,3,5,8,5,7,12
TOMMY-JAY,G,Male,04-11-2009,g@gmail.com,91e7147325cf3ff22207f472bea96d93,91-8657767815,18,23,1,24,6,32,38
Vennela,R,Female,09-05-2005,vennela@gmail.com,3546a01d7fdb258b0df8bf43440b1e77,91-9565685112,4,42,4,46,75,2,77
AIRONAS,G,Male,15-06-2014,aironas_g@gmail.com,e0f4fee68ff5c10f207938bd3610e23f,91-8459564966,59,5,78,83,1,21,22
Basavaraj,DORIAN,Male,26-11-2012,basavaraj_dorian@gmail.com,143a5e61044e1a7c43fe7465916a10cb,91-7545528557,5,65,57,122,85,56,141
Trusha,Ashutosh,Female,22-10-2007,trusha_ashutosh@gmail.com,7ab9c93886b174e3ea7ae20b3c3d3856,91-7829834528,69,47,2,49,39,15,54
AJAI,Q,Male,25-08-2009,ajai_463@gmail.com,ea0e31c80a8572e5a64febccc6b069a8,NA,0,0,0,0,0,0,0
ARNO,CIAN,Male,23-07-2008,arno_cian@yahoo.in,68263c6ed2bc5cb47c77c3dd8961c94e,91-7819754682,8,24,3,27,1,2,3
Kundini,B,Female,25-02-2014,kundini_b@gmail.com,4ee0e0fb3eea55a7fe8bb45b5c3c2366,NA,0,0,0,0,0,0,0
ROMAINE,Navin,Male,21-10-2004,navin@yahoo.in,58c45d9aeab1aa9e1975b0b8d13466d5,NA,0,0,0,0,0,0,0
Hasna,Asgar,Female,23-01-2008,hasna@gmail.com,8134a400acc508b7c10f4690c8799a05,91-9662994566,4,35,95,130,89,3,92
Adityanandana,J,Male,2013-0-12,adityanandana_j@gmail.com,45887a2ad30d36bbdb8dd58f122283bc,91-8359967746,19,3,71,74,78,86,164
Kanakor Kanaka,B,Female,13-02-2011,kanakor kanaka_b_782@gmail.com,11d5291e1ea6cb37851f7711634f859c,91-9568871235,9,1,62,63,61,36,97
Harjeet,A,Male,18-07-2004,harjeet_a@gmail.com,556a4a0d0e8247542238a4e18cd75300,NA,0,0,0,0,0,0,0
Snigdha,X,Female,13-05-2008,x_684@gmail.com,e6a0225f72291dc88f0cbc363a013b30,91-8551535177,6,75,69,144,7,9,16
Inika,G,Female,21-01-2011,inika_265@yahoo.in,741c8799132253c7013e6f735f7e1474,91-8775846877,5,81,5,86,7,2,9
COLT,Q,Male,02-05-2009,q@gmail.com,6860d0f4e09985f35b741594cb9a52d7,91-7769138614,68,6,75,81,5,2,7
Parinita,SHAHZAIN,Female,21-04-2006,shahzain@yahoo.in,c8f5da325b6ddacb6b8d63963e20ea08,91-8198553313,89,83,7,90,2,4,6
MUBARAK,B,Male,14-10-2009,mubarak_b@gmail.com,6aa84317228c85652a827c17c9868058,91-9685825351,9,4,73,77,6,67,73
Mandana,Chandrakirthi,Female,29-04-2011,chandrakirthi_289@gmail.com,9b586fc6daa37d5f27d5bc38423ba3bf,91-9877713257,3,52,78,130,8,46,54
Thangamani,Dattatreya,Male,29-11-2013,thangamani_dattatreya@gmail.com,539f416aea7e7c604500c49cc59edb05,91-9369327598,78,2,29,31,2,34,36
Sarakshi,ANDREY,Female,11-11-2005,sarakshi_andrey_297@gmail.com,d7ea9a05e3a0927e620dd5206218ff5f,91-9437162111,9,3,78,81,65,28,93
ALBY,Kirtikumar,Male,30-08-2007,alby_kirtikumar@yahoo.in,c016271f4010dd64cb2d78f37d391f6a,91-7779225279,47,6,8,14,1,7,8
Sharmistha,CHIKAMSO,Female,11-11-2013,sharmistha_chikamso_324@gmail.com,5b815534f62c038bf70b01661c08475e,91-9824928543,59,6,78,84,72,5,77
Sumit,X,Male,30-04-2010,sumit_x@gmail.com,d1752a889d00333acdb4b92b36eccc57,91-7111275947,5,5,1,6,5,46,51
Navya,Mukunda,Female,06-10-2011,navya@gmail.com,2df5500adc8018a6e6f79dca289fffde,91-7643564924,99,2,9,11,97,3,100
DAVY,B,Male,02-02-2011,davy_b_659@gmail.com,45e1a4c76f0c00c8fa689df469c3a6dd,91-8729219222,7,87,8,95,7,5,12
IREOLUWA,TOBIAS,Male,2010-0-28,ireoluwa_tobias_548@yahoo.in,dcda4a40c9db9c5892a9991bec58d3cf,91-7733348355,8,1,78,79,2,9,11
YAN,A,Male,16-02-2012,yan_a@gmail.com,1edb6826cc20afc0e19631ece9442316,91-8888192289,55,45,82,127,7,9,16
Sarasa,BROOK,Female,24-11-2008,sarasa@gmail.com,b14ef418af737c65c3ec1ecc30347a2b,91-8544555881,83,48,92,140,9,91,100
LANDEN,I,Male,09-04-2008,landen_i@yahoo.in,bfc7619f2424ece06f59ddb0e6c4fc18,91-7432267991,25,9,12,21,94,7,101
Haripriya,C,Female,13-10-2013,haripriya_c@gmail.com,712a28efd38e1b7e1d9ab060227a0de2,91-9159756649,7,7,4,11,58,49,107
MUSA,I,Male,24-03-2012,musa_i_438@gmail.com,f813bbba555343d238021f748ed3cc0f,91-7335923487,7,28,66,94,6,1,7
Niti,BILLY-LEE,Female,26-11-2014,billy-lee@gmail.com,239740a7e3f3e7aa3aa4b7057dc47f14,91-7673464955,2,91,94,185,71,75,146
Vajra,L,Female,03-09-2005,l_258@yahoo.in,a9f4e7c5bbf297d37711b057e623c3e4,NA,0,0,0,0,0,0,0
WARRICK,G,Male,08-04-2009,g_649@gmail.com,9b31168daf3d139ab158bf32252bab59,91-7193348955,65,4,69,73,8,15,23
TEILO,T,Male,06-02-2013,teilo_t_492@yahoo.in,6f797d5b28f9d833726dc077da0564ce,91-7443266152,5,9,91,100,51,6,57
Maina,Mahendra,Female,01-02-2008,maina_mahendra_623@yahoo.in,ce3d9a704f952b9a26d6426f003afb2a,91-9527464634,3,86,3,89,5,22,27
Naganika,U,Female,2004-0-10,naganika_u_619@gmail.com,72dcacdb114bbf682677d925ed355be9,91-8379835885,9,9,2,11,94,5,99
Manisi,AJAX,Female,2010-0-16,ajax@gmail.com,8bf8493c843d189fccd1b198c9d98668,91-7317591792,5,9,65,74,7,55,62
Sudipta,H,Female,30-11-2005,sudipta_762@gmail.com,a1dd2ce73d0d9debc35f64372c5ab59f,91-8767431785,69,8,87,95,6,2,8
Kripa,O,Female,18-08-2004,kripa_o_281@yahoo.in,cc3dc0225343f9a97ec739a4981549fd,91-9437385262,9,54,31,85,6,75,81
Jaya,P,Female,04-05-2007,jaya_p@yahoo.in,5d5f0f97f233a7103df2743fd353def5,91-7281729953,2,28,9,37,6,32,38
ARIYAN,Megha,Male,18-11-2013,ariyan_megha_149@yahoo.in,5843f273674027fe666916490bb96212,91-8435241593,83,66,57,123,32,24,56
Ekaparana,NAKAI,Female,15-08-2011,ekaparana_nakai@yahoo.in,7622d3929100883404712c1a8a440cfe,91-7621567978,38,13,9,22,5,55,60
DARCY,Kriday,Male,15-06-2008,kriday_697@gmail.com,50ac3ae50da6e187cb4210002580aa9c,91-8439889419,1,76,12,88,19,5,24
Sikata,E,Female,29-03-2009,sikata_458@gmail.com,2fb48aeb3ddf09b1ca132c855e86db72,91-7871326635,5,34,2,36,34,84,118
Vidya,V,Female,08-04-2013,vidya_926@yahoo.in,513997237cb633d875b9f4763d9fb23e,91-7542654585,9,52,41,93,29,7,36
Parama,DEAKON,Female,03-06-2011,parama_deakon_394@gmail.com,177a76086f9a8221026a79d804648b0e,91-9572362845,65,49,23,72,9,93,102
LIAN,KAIYAN,Male,26-11-2008,lian_kaiyan_953@yahoo.in,f379fc52b2da186475153ae5933f5590,91-7389568831,56,1,1,2,2,93,95
Dharitri,ISAM,Female,23-09-2013,dharitri_isam_384@gmail.com,69aa352efefb24b3ebfee77d27c3d69c,91-7158887887,7,29,9,38,9,5,14
Sriya,F,Female,24-06-2007,f_186@gmail.com,81a5041f867e9df831b907d3d03605e7,91-7251716763,1,53,66,119,34,7,41
KLEVIS,M,Male,2011-0-22,klevis_m_652@gmail.com,1fdb393455c3234413986ea0dc8232a8,NA,0,0,0,0,0,0,0
Ambuda,MUQTADIR,Female,14-02-2012,muqtadir@gmail.com,ddc64b82512537e0c9660b5ab490e32e,91-7355358919,4,92,61,153,64,84,148
Lajjawati,U,Female,03-07-2008,lajjawati@gmail.com,842ce262b9a74a3b04586921f3c6d0d4,91-9573159917,6,5,45,50,9,97,106
MATYAS,E,Male,11-01-2008,e@gmail.com,134af5699ad76b44504078fd680519d3,91-7212797519,37,21,89,110,4,66,70
ALIEU,M,Male,03-09-2006,alieu_m_764@gmail.com,b000741f76b4468368a7f550d9c482d4,91-9835912954,78,37,4,41,62,49,111
Pritam,KYRONE,Male,29-11-2010,pritam_716@gmail.com,684e4e8e5b9d31b4ca208ed3c61d34dc,91-7413119272,57,51,28,79,5,7,12
CARL,KACEY,Male,03-08-2011,carl_kacey_241@gmail.com,2d61e1f9113edc50ce32b1d04acdc9f2,91-7543699499,53,7,17,24,3,89,92
Vanani,COBEN,Female,07-08-2008,vanani@gmail.com,bcb5c77321b17793439a16aeb5c40e6c,91-7699995595,2,7,35,42,43,1,44
ASWIN,Aashish,Male,08-06-2005,aswin_aashish@gmail.com,948660457bcde7ab9f53b9c3187bfc3d,91-9177493882,65,9,8,17,3,2,5
Manisitha,JAPNOOR,Female,24-04-2005,manisitha_japnoor_715@gmail.com,4b117f499fa8240920861ecf9f3732a4,91-8948499647,8,6,6,12,2,94,96
Geena,Arivali,Female,05-07-2012,arivali@gmail.com,0e48a2c5c0131f3fd0eaf0222e9b86bf,91-9695934546,7,7,87,94,4,48,52
PETR,V,Male,16-06-2009,v_547@yahoo.in,d8dbd285acba5d5dec7594d95ea3a9f0,91-8874453359,1,1,62,63,16,32,48
KODEY,N,Male,11-01-2005,n_957@yahoo.in,898a759a8eb516e0c7cd1c2319763555,91-9797549951,7,7,96,103,43,2,45
Kanta,Shatrughnaor Shatrughan ,Female,05-03-2012,shatrughnaor shatrughan @yahoo.in,164b50835a3243a09be42d81c7037322,91-9874133519,2,6,79,85,79,3,82
Devaki,KAYDEN-JAMES,Female,2011-0-28,devaki_kayden-james@gmail.com,b8e235542472c34a4c701db087d812fd,91-8589571695,31,68,53,121,6,2,8
Anya,N,Female,18-09-2007,anya_n@gmail.com,4959ef904a9d29509b968a7eacb934a0,91-7685146378,52,27,86,113,65,2,67
Punarnava,O,Female,2005-0-10,punarnava_o_462@gmail.com,609f1007fd1d928be674feec45236f67,91-7996636768,62,1,3,4,26,68,94
SULAIMAAN,R,Male,11-08-2011,sulaimaan_r@yahoo.in,1802445e51f96fcadfe5b3d863d5e936,91-9152997255,8,2,43,45,31,4,35
Sarada,MOIZ,Female,2008-4-31,sarada@yahoo.in,9ea1752e512c6cadd9b517fdcddf5966,91-9298183577,13,73,39,112,9,9,18
Gandharva,A,Male,27-04-2011,a_472@gmail.com,e44d4418951039f354d24a64e177f260,91-9213393561,76,4,24,28,81,48,129
DARION,A,Male,19-02-2006,a_468@gmail.com,84803185617a46b86cda37496f6b21c9,91-7285746345,28,8,69,77,8,2,10
WARWICK,JACOB-LEE,Male,2011-0-28,jacob-lee_967@gmail.com,85b97ccbcfb2f58935c5c79c9ea8e123,NA,0,0,0,0,0,0,0
MATHEUS,P,Male,2010-0-13,matheus@gmail.com,363dcbca7cefa19b138d3257fb144482,91-7555452812,7,48,6,54,9,8,17
Rangan,S,Male,11-09-2006,rangan_s@gmail.com,f22fd4f96317fc0b9391f3f468523f4b,91-8481187636,3,93,1,94,7,88,95
Kalindi,N,Female,22-04-2006,kalindi_n@gmail.com,c607809db8eaec237d4526a24cadf516,91-9239697881,7,5,7,12,46,4,50
MAHMOOD,Y,Male,20-10-2012,mahmood_y_682@gmail.com,67b7bcd0aba072670009ec2fa8e217bc,91-9869827515,33,14,4,18,16,3,19
ISSAC,DEIVIDS,Male,14-11-2006,deivids@yahoo.in,84218f6d75215bcba9ad98d100ce6392,91-7592826889,84,6,79,85,93,79,172
Punamor Poonam,Y,Female,30-05-2012,punamor poonam@gmail.com,5a61e222b15d4fff296a1aa03ce476c4,91-8221147312,62,9,6,15,8,77,85
Nityapriya,P,Female,24-07-2012,nityapriya@gmail.com,807a43e0ca320ced7fd15de666521af1,91-9813798596,4,63,62,125,1,6,7
Somatra,ABDELRAHMAN,Female,09-10-2007,somatra@gmail.com,d4b4f64bb831a8c26b26633372ff248f,91-7812983168,9,34,74,108,23,86,109
PEREZ,BODEN,Male,03-01-2007,boden_831@gmail.com,969a7f704f97e03b0a7232866b3d23a1,91-7738742918,2,23,18,41,1,75,76
Sita,L,Female,11-05-2012,l_416@yahoo.in,09afb2ae313f2672be48988bd0497657,91-7194914389,2,13,5,18,99,48,147
Menaka,R,Female,16-06-2011,menaka_r@gmail.com,ad66aac868bcc5536066b5e351da3e5a,91-7553189295,5,9,9,18,3,95,98
ARTIN,ABDULSAMAD,Male,22-10-2004,artin_abdulsamad_681@yahoo.in,2e31abc30fff5211df99a21aa525e6d8,91-7688858874,28,26,14,40,5,17,22
DARIS,Q,Male,12-08-2005,daris_q@gmail.com,434d347f4d2ef80dfc45a8fb81014a64,NA,0,0,0,0,0,0,0
Suchandra,NATANIEL,Female,05-04-2009,suchandra@gmail.com,06e388d1b888dec7d39ed88cb7e76a52,91-8524951774,82,11,36,47,95,2,97
MOHSIN,NAITIK,Male,12-11-2010,mohsin_naitik@gmail.com,3e9b21efb9b9420f1c62493a82c36555,91-9547433531,96,94,62,156,42,69,111
Chitramala,Tarik,Female,15-10-2011,chitramala@yahoo.in,dbd7b88dce656138451fe5d31659420d,91-7334221193,4,62,58,120,1,75,76
Charitra,T,Female,01-04-2012,t@yahoo.in,423272f3c9a2f6b5e6fb1239d8cc0c0e,91-8122964599,53,28,4,32,7,6,13
DARNELL,PAYTON,Male,25-06-2005,darnell_payton_572@gmail.com,f2608d0f06e56d1ba68804dd21ca7c60,91-7147228852,2,3,56,59,3,86,89
Vanadurga,F,Female,14-04-2006,vanadurga_f@gmail.com,505a31ea2ff54c753da765fb1686eaaa,91-7977842463,61,86,8,94,8,1,9
Ahsan,Arivoli,Male,21-04-2013,ahsan_arivoli_735@yahoo.in,3d8e4c08ff93eae7abf74a60a320efc4,91-8582781845,2,1,57,58,7,4,11
Omvati,Maheepati,Female,19-01-2005,maheepati_835@gmail.com,62ba1b16af5726448db8e307993a0eb3,91-9785593788,9,4,5,9,5,47,52
Harshada,T,Female,20-07-2011,harshada_t@gmail.com,c872f092b7dd9b46903d198de481a77d,91-7935423923,6,62,5,67,7,2,9
JAYMIE,Prachur,Male,25-04-2012,jaymie_prachur@gmail.com,f188e7845e28b24cfe5caae93ddda053,91-7593664993,63,1,1,2,1,33,34
KAILASH,ADETOLA,Male,26-09-2011,kailash@gmail.com,5e2d22a8ea167e41a3a97f0442125644,91-7863454677,1,76,63,139,3,12,15
CHRISTIE,C,Male,10-04-2012,christie_c_629@gmail.com,01bfbb6cc0851a26fa6ee6c8bc79a2f4,91-8549254416,98,3,96,99,74,18,92
Farid,JULIO,Male,13-10-2013,farid_738@gmail.com,b6ec418ada176ba3316b857ce080e593,91-8472396976,7,79,61,140,5,9,14
Gitanjali,E,Female,15-07-2009,gitanjali_e_237@gmail.com,396ce8da12a522dc6cd49a0cff22a956,91-7644835976,68,25,3,28,97,4,101
MADDOX,J,Male,05-06-2009,j@yahoo.in,2bd8c2bca6d2654d92887deeab3eadcd,91-8337248539,4,25,32,57,4,8,12
Raksha,A,Female,16-04-2012,raksha_a@gmail.com,74f0350ca2b83d39fb9e39651f893b4c,91-7156941443,2,94,83,177,18,8,26
Sambit,F,Male,18-11-2009,sambit_f_347@gmail.com,b3246784a7dd44f76f8e3654c92f5c7a,91-9348122933,4,81,45,126,3,87,90
SAMPSON,JASDEEP,Male,19-01-2009,jasdeep@yahoo.in,c588bf48d34275c91366a1ca33cd37f3,91-7748852449,3,49,3,52,3,92,95
Devamayi,TIAAN,Female,20-09-2013,devamayi_tiaan@gmail.com,e6805a66abde667f8b64a42e082bf5f8,91-7389532469,36,2,1,3,9,24,33
Kaishori,D,Female,30-07-2008,d_497@gmail.com,94b9290e6b6ba444d4d49b7ee84dfd12,91-7531779277,22,73,1,74,2,5,7
Navnit,NEMUEL,Male,05-07-2005,nemuel_327@gmail.com,84003bf70c6a24041fcff383db875c0b,91-9946696946,1,5,8,13,65,7,72
Shantimay,Adinath,Male,19-04-2012,shantimay_adinath@yahoo.in,94362f04e6c273f60ec326d5737fe01c,91-7528777662,7,7,38,45,1,97,98
Narinder,Y,Male,28-02-2013,narinder_y_954@gmail.com,9dc78b3d5f4cde01029ce6244833ae44,NA,0,0,0,0,0,0,0
Urmilaor Urmil,O,Female,15-05-2013,urmilaor urmil_o_738@gmail.com,0edc35dbc87d10eb85279123a5103afa,91-7882798985,19,58,82,140,5,7,12
Jithya,S,Female,08-03-2007,jithya_s_572@gmail.com,0261cf030acee377b2ff413d9f967de4,91-9615662486,8,52,27,79,7,61,68
Manas,LUKASZ,Male,11-01-2009,manas@gmail.com,6201d0e2e2dec286ef4b9772ecf01767,91-9486927459,6,6,54,60,2,56,58
Shiuli,P,Female,18-02-2013,shiuli_652@gmail.com,7c693bf103a27f79a34526a43a65d10e,91-9557184356,7,6,78,84,8,45,53
SHAYON,Y,Male,2007-0-8,shayon_y@yahoo.in,244dd61fa2fa1360371f3a3630007ef4,NA,0,0,0,0,0,0,0
Sana,Prabodhan,Female,29-11-2006,sana_671@yahoo.in,9ff3d384efdc9929e2322af6d37a5b9c,91-7926387478,2,65,26,91,24,1,25
KYRESE,N,Male,01-07-2004,kyrese_n@gmail.com,c0b2c2ff11ad583095d1e8ed7793be9a,91-7237383338,4,6,96,102,65,86,151
DRAY,JASTIN,Male,05-10-2013,dray_jastin@gmail.com,b94005195ae45dacf32f031a4df1d07f,91-7986127215,39,5,55,60,4,42,46
Darpanika,T,Female,09-10-2007,darpanika_t@gmail.com,f2e35d5e5280a430935d50d740e38a1b,91-9822489333,7,62,42,104,8,4,12
Surya,FILIPE,Female,21-06-2008,surya_filipe@gmail.com,b3cbfec9b9d824b3f2bc40f3afb8dab5,91-8666959256,92,2,82,84,1,6,7
Arivalagan,TEEGAN,Male,01-04-2006,arivalagan@gmail.com,7842d6ef2a67f85a9cb243a5e06fbbaa,91-8391372927,72,75,2,77,9,6,15
Mukti,L,Female,03-11-2007,mukti_l@gmail.com,bdc95fddcb5253d045dbdff01cd01c02,NA,0,0,0,0,0,0,0
Tanima,P,Female,21-02-2014,tanima_p@gmail.com,dc9c5d595b26770d687e350f952019ac,91-7493114158,41,69,67,136,1,76,77
Angana,REG,Female,19-04-2007,angana_reg@gmail.com,2b94593a803593fb7cf53c4b7a80b328,91-8683885544,34,98,19,117,2,98,100
Vishakha,DHRUV,Female,12-01-2006,dhruv@yahoo.in,a914a0d124bb5fa239b094f72c08e664,91-9357655899,14,7,6,13,4,3,7
Chandika,I,Female,2012-0-15,chandika_i_172@gmail.com,78fd206f121bb967b3a59fb8facb5158,91-7357781863,89,2,5,7,76,2,78
Rashmika,SORIN,Female,08-08-2007,rashmika_sorin@yahoo.in,16877fffa9d0523f41bf58274465691b,91-7349895311,86,45,4,49,36,42,78
Kamini,E,Female,16-04-2005,kamini_e_387@gmail.com,2fff6aea48a36200b810da6ea948d51c,91-9913288399,3,4,65,69,94,5,99
Champakali,N,Female,30-10-2012,champakali_n_124@yahoo.in,3b03d974e98868af992477689c570322,91-7235959696,45,64,94,158,34,63,97
SANTHOSH,SHADMAN,Male,12-05-2006,santhosh_shadman_967@yahoo.in,03d9d8cafd75117615a6081a7a9b5f8c,91-9818934716,94,72,7,79,19,48,67
Amoda,Taj,Female,29-09-2004,amoda_taj@gmail.com,72c383bf4c36fb868dcb0a1d5992b1da,NA,0,0,0,0,0,0,0
Vaijayanti,JAHZIAH,Female,24-01-2013,jahziah@gmail.com,d581b320702800a2a424508974e3952d,91-9843279154,9,2,8,10,79,15,94
RUHAN,AKAR,Male,30-11-2013,akar_248@gmail.com,82829a6de1ca0a4ff4682ff7af4428fe,91-7228186972,59,46,8,54,6,38,44
ADITYA,J,Male,04-02-2012,aditya_j_865@yahoo.in,cce733319ac4ca5606660869ce8f8f24,91-7377584111,2,13,49,62,3,4,7
OMAR,V,Male,2006-0-25,v@yahoo.in,172ae755b0299f0994492f9bad98c243,91-7539698186,14,79,95,174,51,9,60
HUD,L,Male,15-06-2007,hud_925@yahoo.in,e8c20fe9ac8ce983b1e657d6a86ef0ba,91-7826272445,9,33,4,37,34,14,48
Disha,O,Female,04-06-2007,disha_o_453@yahoo.in,6f2a6bafa884399192a5f7eaab81447a,NA,0,0,0,0,0,0,0
Jasodhara,KIDUS,Female,22-04-2004,jasodhara_kidus_719@gmail.com,ccb539edd9b86e9b109c51d24a25f5f0,91-9636338582,4,71,2,73,26,7,33
Ekachandra,KYREECE,Male,07-04-2005,kyreece_715@gmail.com,6d7b61909fed5e60d6cb55f860dbbee8,91-9165325132,26,8,1,9,5,1,6
Rohitasva,STELIOS,Male,02-04-2008,rohitasva_stelios_469@gmail.com,41f77df56c844d8306aeb4eb4ff4c144,91-7398342661,71,1,74,75,8,69,77
Paramita,EZRA,Female,04-01-2009,paramita_643@yahoo.in,4a53a80ae39adc5ed4d7b19882f413a8,NA,0,0,0,0,0,0,0
HUMZA,Lankesh,Male,18-01-2009,humza_lankesh_892@yahoo.in,f7b18bde48d86526841952820c197039,91-9198664457,33,1,7,8,71,81,152
APOLLO,U,Male,17-02-2010,apollo_152@yahoo.in,724063ae278feef1623c9f501a63878a,91-7462127961,5,98,1,99,87,78,165
JASPER,SHANE,Male,12-07-2006,jasper_shane@yahoo.in,bfac00264e77bcf3fc637f17716ca49a,91-7938667382,7,8,47,55,82,58,140
Upasana,G,Female,17-05-2004,g_124@gmail.com,ee8a5b1bbeedfb188503f8a10760fbf3,91-7365212436,2,33,27,60,1,9,10
TOMMI,MARCIO,Male,03-10-2011,marcio_654@gmail.com,c0c4feb331db7bc6b965034a292d6eba,91-9321428259,3,42,6,48,25,7,32
HASNAYN,TANVIR,Male,26-03-2008,hasnayn_tanvir_261@gmail.com,f80c21c9aa2dbc382143846e9a10c586,91-9671726773,37,94,6,100,5,37,42
Siddhi,Ruchir,Female,21-01-2014,siddhi_841@gmail.com,727d28a1a618dd0ace7647bdb80230c7,91-7836414839,3,5,27,32,19,77,96
MARTYN,Y,Male,05-11-2008,y@gmail.com,888cb559020393a4faf80e5b1d1ee6cf,91-7196226331,38,6,97,103,94,9,103
Pavana,Q,Female,01-04-2007,pavana_q@gmail.com,3ff38df1035ae681f53b1f2ecb82d4a2,91-7491932389,1,3,2,5,21,29,50
ETIEN,RUDY,Male,03-08-2010,etien_rudy_867@gmail.com,f88bd3f8012c30dedf9747bcc40036eb,NA,0,0,0,0,0,0,0
Dayita,G,Female,22-07-2006,dayita_g@gmail.com,cac2f8364f8e1d6dfb0b4d10ffad6642,91-7343734451,72,6,9,15,14,42,56
Thulasi,DONTAE,Female,12-04-2009,thulasi_526@yahoo.in,551c96b1e857070171f4e163bb5f92d9,91-7573919617,9,33,54,87,16,4,20
Gitika,Y,Female,15-01-2010,gitika_y_985@yahoo.in,b540212ea397424dbd9be004cac3ea4b,91-9757264362,56,55,92,147,22,7,29
RICARDS,Shirish,Male,19-10-2004,ricards@gmail.com,ebeff1aa5f72364fa771c59786f7afba,91-8251615699,16,65,4,69,27,5,32
Niloufer,Q,Female,30-11-2009,q_816@gmail.com,7ed01bedc8b2bad1c10595eb3880f3db,91-9531952182,42,3,47,50,3,1,4
Kavini,Q,Female,2011-0-15,q_142@gmail.com,3f0b6b12bbb8912eef2abcd4f10425b7,91-7894841148,5,25,1,26,52,84,136
AADYA,S,Male,01-04-2007,s@gmail.com,2b0fa535ec44134116537d45a0746b97,91-7326221455,3,7,87,94,5,46,51
CYRUS,PAA,Male,12-04-2014,cyrus_897@gmail.com,86e2921cf360c2312d4b17829f192587,91-8327247187,78,9,3,12,9,57,66
Pritha,KYRIACOS,Female,17-07-2012,kyriacos@gmail.com,21d6f450abed944913652edfb9d41515,NA,0,0,0,0,0,0,0
Shanmukhaor Shanmuga ,RHEON,Male,11-04-2009,shanmukhaor shanmuga _rheon@gmail.com,19a5625d4dd4d7de7f327c9626cff891,91-7221698384,15,6,7,13,3,14,17
Sphatika,Aghat,Female,01-05-2011,sphatika_aghat_342@gmail.com,2d6a1237b5ac421bd8d85bcc663eb747,91-7749891936,1,2,7,9,78,89,167
KLAUDIJUS,Sachit,Male,11-03-2005,klaudijus_sachit@gmail.com,4bfe6605d4e624da7f1fa41dbc0d9af9,91-7298645123,4,9,5,14,32,72,104
Sonam,FINDLAY,Female,09-07-2011,sonam_findlay_621@gmail.com,6465ab73e29308b4f3ccc6d8525c7db7,91-7882277785,8,4,74,78,92,78,170
ARMANDS,E,Male,2006-4-31,e_325@gmail.com,f52d4a629f53d2db6c6510f60405571c,91-8375968396,3,7,1,8,42,7,49
Chandrima,M,Female,08-07-2009,chandrima_m@gmail.com,6522e68c3ff9eef9d22e6a91803ac3ea,91-7134497965,8,63,75,138,37,98,135
Mohini,PINCHOS,Female,14-07-2011,mohini_pinchos_397@gmail.com,3c8cb1e6c47d064dec9d1f4905107c6e,91-8152429391,8,6,54,60,8,81,89
CASSIUS,MELCHIZEDEK,Male,16-03-2013,cassius_melchizedek_459@yahoo.in,3f62edcc7ddd65f013fc8a4ad519ad61,91-7129318836,53,32,8,40,2,5,7
KONOR,H,Male,30-09-2011,konor_h@yahoo.in,e81c7a552fd5b91f69b90629fad69394,91-8847883566,76,31,39,70,3,85,88
Valmikior Valmik ,U,Male,03-09-2011,valmikior valmik _u@yahoo.in,b1c60b7fa6a4b7efa5afc29e8e7d5aae,91-8186258773,8,92,25,117,27,13,40
Manmohan,X,Male,24-08-2008,manmohan@gmail.com,700c4af1e8bb7fc5fe90fe49cac15495,91-8752315842,7,71,8,79,19,9,28
ARRY,B,Male,30-05-2006,b_398@gmail.com,be0176413357820283a6a63b0d793bd2,91-7847522414,96,4,53,57,8,3,11
Sanjushree,DIHAIN,Female,24-05-2010,sanjushree_164@gmail.com,5590d0de1ebe4c20bacf881a3ee8c755,91-7641126318,33,7,54,61,87,39,126
Hansa,SYLAS,Female,01-11-2013,hansa_sylas_721@gmail.com,373e9cdbe6e6ae806c50c0a61607a5e8,91-7528525212,5,33,2,35,2,3,5
Aninditha,T,Female,11-01-2008,aninditha_t_752@gmail.com,5f2a9b13a16bcbbcbb6a8abc698f9bbf,91-9729492974,44,87,95,182,4,8,12
Anandita,M,Female,15-06-2008,anandita_m@gmail.com,65d5247386b17325b8bb00b47fe1afa5,91-7461768557,34,35,68,103,7,36,43
ALFIE-GEORGE,L,Male,2012-9-31,alfie-george_l_357@gmail.com,f58213b62104d3758e46c98ced282721,NA,0,0,0,0,0,0,0
Gandha,O,Female,09-11-2010,gandha_346@gmail.com,7ccd4f2287703d42cf8ebd3c0aa19184,91-7244249794,27,3,8,11,15,42,57
Champamalini,Z,Female,29-04-2009,champamalini_z@gmail.com,80dd0c160edfe483ba1775710f773c7f,91-9562482598,2,6,28,34,51,9,60
EVERTON,Chetana,Male,02-07-2011,everton_chetana_415@gmail.com,746a5d92787639f196aee48c632a1a83,91-7427258285,9,12,37,49,7,49,56
Nikhila,Pundarik,Female,06-02-2009,nikhila_pundarik_258@gmail.com,4ab93fbaab93d3ae9bb966be9679a41d,91-7674765153,66,14,3,17,6,7,13
Gita,C,Female,03-10-2007,c@gmail.com,e1e35e2f2875fc28b2ba7da8532cd1ac,91-7261711167,46,1,9,10,9,69,78
Tusharkana,Y,Female,09-10-2013,tusharkana_831@gmail.com,ed94595da2ad288b68b0c119ae548f55,91-9295289323,75,88,4,92,5,27,32
KELLEN,JAKSON,Male,2010-2-30,jakson_719@gmail.com,650ce4d7df623eecb86f5d045aad892b,91-7899226481,4,35,5,40,31,6,37
Parindra,J,Male,26-10-2013,parindra@gmail.com,8246cf45715b8581a485d6510a8c1574,91-9777346469,86,5,4,9,49,15,64
Arunima,QAIS,Female,14-09-2005,arunima_382@gmail.com,b7aeca92819d1a116aea4cf60dff16ae,91-9992829652,63,27,2,29,52,46,98
Ila,Q,Female,28-07-2008,ila_q@gmail.com,39ab7e96abfa83f9ec3eb567e0d11e4f,91-7513428418,95,73,3,76,84,3,87
Siddheshwar,F,Male,02-03-2009,f@gmail.com,ae391a9c489eed144622e2a8e18531aa,91-7495663545,36,76,8,84,7,46,53
Samvath,K,Male,04-07-2012,samvath_k_514@gmail.com,f6e2607f24a564de5c5c7d2fec4eed8b,91-8244251944,9,34,8,42,6,58,64
LAYTON,Vardhaman,Male,24-10-2011,layton@yahoo.in,55f2f3e3f07b3e48045dbba32d67223c,91-7996169575,68,7,8,15,33,28,61
Asmita,Madhavdas,Female,05-11-2011,asmita@gmail.com,91b938ce679a10b15265f4219ce0ebc2,91-9552987977,52,5,52,57,8,5,13
LEIGHTON-LEE,F,Male,21-08-2012,leighton-lee_f@yahoo.in,a113740e74aff109c74d724343baa2d5,91-9839644414,9,2,5,7,56,68,124
LAYSON,E,Male,23-07-2009,e@gmail.com,3477139758717ece6e304e3dc3175a00,91-7886991499,28,88,12,100,71,1,72
Kuntala,FLAVIAN,Female,08-03-2005,kuntala_flavian@gmail.com,8434cf709762072f5ab4d2439a2fea43,91-8365585899,69,66,6,72,59,34,93
IESTYN,O,Male,26-03-2014,iestyn@gmail.com,add90aef3f09ffc739992e8c07f8e61b,91-7524112974,1,33,83,116,63,44,107
Chandraja,NATAS,Female,17-04-2011,chandraja_natas@gmail.com,540d48e8e8907a367fe13ebfa19a43a5,91-9221686172,3,93,9,102,16,84,100
Kurangi,GENNARO,Female,19-07-2010,kurangi@gmail.com,c3d309064940086864c43dc7cdbcba73,91-8917347275,6,61,72,133,8,5,13
Gandhari,JACOB,Female,29-09-2012,gandhari@gmail.com,a7fad30c13052bf62b7ac95650700dfa,91-9668431215,83,1,49,50,1,18,19
UBAY,SHAYDN,Male,23-04-2010,ubay_659@yahoo.in,6a9317cabc1dc0cee67f05b7fc0baaa1,91-7983467437,9,5,5,10,2,7,9
Shyama,TINOTENDA,Female,08-06-2011,tinotenda_637@gmail.com,4b1e21bbcff6598c80fcabb5f489940e,91-7284524515,3,33,8,41,9,9,18
Samit,LAYTH,Female,26-07-2011,samit_layth_286@gmail.com,f396874b16181990bb8752d9a493d323,91-9174854389,75,3,13,16,81,95,176
Nishant,N,Male,2004-0-15,n@yahoo.in,338bec4f2b389fcbaaa3cd5d1d0dc6e8,91-9293169485,4,6,27,33,4,97,101
Chitra,Neelkanth,Female,19-04-2008,neelkanth@gmail.com,eaf84ff5ec2308353a1a7a2a4c1facc2,91-8899618884,6,6,57,63,28,5,33
Rajnandhini,LAWE,Female,08-11-2012,rajnandhini_lawe@gmail.com,1dc385f67a27bfae37c1681f67253046,91-7724817746,64,85,1,86,1,4,5
RHEAN,CONNA,Male,26-03-2009,rhean_conna_843@gmail.com,a940bed5557b112056c61a508e02d4a6,91-8722996964,99,33,4,37,7,26,33
Sharad,H,Male,27-05-2007,sharad@gmail.com,8558130b9cce88b86fbefe0e6fa0b33f,91-7547544487,87,62,16,78,7,6,13
Amoda,SHEM,Female,24-10-2013,amoda_shem_135@gmail.com,70486ad4d6bdda28ad972a1883abfbc9,91-8883388662,83,95,48,143,15,44,59
Shantala,I,Female,12-10-2007,shantala_i@gmail.com,2b91b5986ba9c9a62b084d6f2925098d,NA,0,0,0,0,0,0,0
Sultana,X,Female,29-02-2012,x_658@gmail.com,a3d12b088e38adc030f143432de70a09,91-7518853914,42,3,48,51,82,71,153
QI,O,Male,07-10-2007,qi_392@yahoo.in,3bf5ecafe9c07746c1ccacfe068b3037,91-9672569276,2,6,2,8,9,6,15
Nimish,ARTIE,Male,03-08-2004,nimish_artie_283@gmail.com,7ecb13f3be6fecf0ae3baa54831fd5a5,91-9722124316,3,4,47,51,2,5,7
Deepaprabha,F,Female,03-07-2008,deepaprabha_f@gmail.com,af6907183a68e7ea37559fcca6735c5e,91-7641491358,28,5,28,33,38,99,137
Deepti,CAISON,Female,2009-0-31,deepti_caison@yahoo.in,fca045cf5973ba71f07ce204944fc50a,91-7151383743,8,5,5,10,43,94,137
Devyani,KAELEM,Female,20-10-2009,kaelem_837@gmail.com,d2f397a44495c2ba7a3dabc90026ff92,91-9413974963,64,33,19,52,3,2,5
JULIAN,RIYAZ,Male,03-06-2013,julian_riyaz_186@gmail.com,cf409fa04aea7870931384ec69535271,91-8817829882,68,75,5,80,62,1,63
Darpan,B,Male,07-06-2004,b@gmail.com,d0f602b9976ae5f099be7e3da6c11b7f,91-9191184122,8,27,1,28,99,2,101
Kalanidhi,ZACHERY,Female,06-06-2009,zachery@gmail.com,ffe9cf3c3caacfcf3907517824fdc7e1,91-9173324634,1,5,75,80,79,2,81
ENIOLA,G,Male,28-03-2007,eniola_g@yahoo.in,72776108e65b94fea7b81ba64ecf6825,91-7672695966,9,36,6,42,82,3,85
Tarannum,Hridik,Female,24-10-2008,tarannum_hridik_926@gmail.com,60ac32cce837e0721881d4a51944ab88,91-8239947415,46,1,4,5,55,59,114
ADEMOLA,MORTEN,Male,18-08-2013,morten_618@gmail.com,e5cf7c7aaa0035d77dc25bd047d9db45,91-8271244874,74,2,28,30,7,12,19
Kilimoli,W,Female,12-08-2008,kilimoli_w@gmail.com,7c4f2a081f190eb35959030edf869882,91-7311263253,1,56,6,62,41,6,47
Vedprakash,O,Male,05-10-2011,vedprakash_o@gmail.com,8bfd0ee3279ed619c4b78617b703f1e8,91-7475376193,2,4,2,6,32,4,36
Umrao,Bankebihari,Female,18-01-2009,umrao_689@gmail.com,5fcd59bd08fba496e1be06156c817d67,91-7699836789,9,68,9,77,9,6,15
Ayushmati,Fadl Ullah,Female,15-02-2009,ayushmati_fadl ullah_326@gmail.com,5e7825330b220dfb4d9c6e33d5c9aabe,91-7494674692,4,75,1,76,56,1,57
Priyamvada,Z,Female,12-02-2006,priyamvada_z_194@gmail.com,41eb9d1e5c5590a9c682cda8ae5426db,91-7211991114,6,49,8,57,37,15,52
Angamuthu,N,Male,05-07-2009,angamuthu_n@gmail.com,5daa5bb238b0850c1322ab84b3355ae5,91-9458771819,17,93,1,94,73,83,156
Shravani,SHAKAI,Female,06-08-2008,shravani_384@gmail.com,41e05217a65cb0e09eea6ec51ba91713,91-8434124993,1,12,9,21,89,9,98
Sunanda,EFAN,Female,12-06-2007,sunanda_efan_319@yahoo.in,19db95e4a7dc2558e4222299502e7a37,91-7594875319,7,84,99,183,76,7,83
Kusumavati,C,Female,21-02-2009,kusumavati@gmail.com,c23dc6d2d0fe1310c358040313d7af50,91-8841611133,5,8,35,43,3,8,11
Mahiya,MOTTY,Female,09-09-2005,mahiya@gmail.com,896fb9607875c0a69eb8c272f3907204,91-7588536617,45,3,3,6,6,39,45
KORY,L,Male,13-03-2005,kory_l@yahoo.in,ee19eac03f90353bb7da125699ffd052,NA,0,0,0,0,0,0,0
Bipin,I,Male,10-05-2009,bipin_718@gmail.com,884d9669e20b7ca9dfe7757d6dae70e5,91-7827124643,63,9,73,82,9,8,17
Nripendra,H,Male,02-10-2008,nripendra_915@gmail.com,ed3f9b916eed6d8a405b06fb9369196b,91-7275636128,79,1,6,7,57,7,64
Monisha,Faarooq,Female,17-04-2009,monisha_faarooq@gmail.com,43d59785692d96198afd7aa010950322,91-7324976315,4,6,28,34,3,1,4
Jayani,U,Female,2010-0-15,jayani_u_638@yahoo.in,6cdc38b698af83c697606002973b58d8,91-8459431228,51,8,9,17,29,3,32
HUMZA,C,Male,28-07-2004,humza@gmail.com,55e4905070daae233ac402328fbdab08,91-7868666762,2,4,66,70,5,1,6
Ishanika,U,Female,02-06-2006,ishanika_u_327@gmail.com,1e1e35db737c87721aa066119b210e47,91-7623872485,6,9,9,18,52,58,110
Deepana,Z,Female,02-01-2004,deepana_964@gmail.com,cf2162beff22cab16273db6184b88500,91-9163274434,81,85,98,183,39,2,41
Sati,RIYADH,Female,20-04-2011,sati_riyadh@yahoo.in,eb281a7610df3b512c85bb7cc704bf23,91-8396744577,5,24,35,59,2,9,11
CAN,TJ,Male,2011-0-19,tj@yahoo.in,0d6a9e7d6ed9e00da4a68f520b2fc569,91-8381442585,8,84,63,147,98,41,139
LEELAND,E,Male,01-10-2008,leeland@gmail.com,bfcf3a406cfdbe5c40c1a0e88298126a,91-7783539968,33,4,31,35,49,71,120
CIRO,Y,Male,11-10-2011,y@gmail.com,3f85a3e484925e3fc09ce686c7062b55,91-9522514236,3,2,9,11,78,27,105
YARAN,LEWIN,Male,06-09-2006,yaran_lewin@yahoo.in,653d43df0657f0d4aecf1edd22b14755,91-9345366661,14,86,68,154,7,4,11
Sadiqua,S,Female,27-08-2014,sadiqua@gmail.com,cdb1f27cb09fd498b662b0159cdbab84,91-7584584597,87,3,6,9,24,41,65
TAIDEN,C,Male,29-09-2011,taiden_c_953@yahoo.in,0ff1d67680099186d48af19004964f7a,91-7152364546,1,85,2,87,38,44,82
Gyanada,FIONN,Female,07-09-2005,gyanada_fionn@gmail.com,8865ce21ce69585ef684bf6804eca0fd,91-7238688192,47,56,1,57,82,83,165
RANDY,B,Male,15-04-2012,b@gmail.com,baf18df9ef36d3dfcdaa3504c44c569c,91-8795718327,3,37,3,40,32,9,41
Tarunika,Prayag,Female,06-11-2005,tarunika_prayag_542@yahoo.in,3537a7511ded9563d6a34ca6c15af1b5,91-7248265739,29,65,75,140,14,28,42
AHNAF,UBAYDULLAH,Male,10-08-2009,ubaydullah@gmail.com,4a0458306f6174dcfe9dd6fce022dc33,91-8191526578,7,25,72,97,6,9,15
Nishita,J,Male,2007-0-14,j_718@yahoo.in,5d697d0185779ffde3018d0da347a3b5,91-7123236934,78,7,92,99,8,3,11
Pramila,Chandranath,Female,20-03-2008,pramila_chandranath_975@gmail.com,ccecbfd135cebabad4f4ab014694fbb4,91-7991958642,83,59,72,131,38,8,46
HOWARD,KIAN,Male,02-06-2013,howard_kian@yahoo.in,dae6e48ababa0b6db167fb1bf7b1d390,91-8559128977,31,7,3,10,31,75,106
Anusri,FINLEIGH,Female,2006-0-17,anusri@gmail.com,b09a9fd40b4658ea509c151a9eb9b2c9,91-7442191867,96,42,35,77,3,44,47
PATRIKS,Acaryanandana,Male,05-06-2012,patriks_973@yahoo.in,44e1126cab63284e5ef2c9acfcd4ff55,91-7115557213,32,4,12,16,9,39,48
AUGUSTUS,Chitrasen,Male,09-11-2013,chitrasen@gmail.com,c00aadd70616bbbdcdcd7b23568d6f3f,91-7154186639,9,75,95,170,6,67,73
Janamejayor Janardan ,DERRICK,Male,08-07-2009,janamejayor janardan _derrick@gmail.com,3e77aa0eaf719091e3b837ccc505bf43,91-7429574477,9,5,37,42,3,4,7
Sunanda,C,Female,16-02-2014,sunanda_c@gmail.com,da668a4d6b58554cd35d4e249408a662,91-7641928945,2,2,4,6,9,68,77
Draupadi,LEX,Female,28-09-2007,draupadi_lex_327@gmail.com,7f415aee8a9bbf1b91017b8dc156a688,91-8878822564,6,17,52,69,8,57,65
SAMIULLAH,M,Male,05-06-2010,samiullah_m@gmail.com,382d76fea9b481f2c5f3e895d091f911,91-8761699336,3,63,66,129,9,6,15
Gandharika,K,Female,13-10-2004,gandharika@gmail.com,bf00c9e08c3d1f55c1dbdde6e724b1e8,91-7561589635,45,6,1,7,32,1,33
NAEEM,R,Male,17-09-2014,naeem_r_734@yahoo.in,576e1946bae8f3b9cf5c867a7d7165ab,91-9828753473,26,2,2,4,3,27,30
Anavi,G,Female,2006-0-20,g@yahoo.in,07a1b8b0d6430e6de4233f1109a1a097,91-9793445329,11,6,35,41,1,31,32
Ahilya,BENJAMIN,Female,26-11-2010,ahilya_benjamin@gmail.com,341f61ac089f18f72ddd5e41f2be4cca,91-7288164781,72,97,82,179,6,54,60
Quasim,D,Male,22-11-2013,quasim_d_835@yahoo.in,b04689613ed6c7e5577aefcb3c3d467f,91-7352643764,33,13,24,37,79,5,84
AKIL,KILIAN,Male,15-10-2010,akil@yahoo.in,81d866c88b56834ce744e0da72b1d0a6,91-7315541365,53,7,98,105,41,21,62
Hetal,MAHAMED,Female,05-08-2007,mahamed@gmail.com,9e5a7ebcd0c34c94c16e603cfc733091,91-8961562128,3,2,5,7,1,95,96
Shaswati,M,Female,29-10-2012,shaswati@gmail.com,a98d49ec54e93721c042a268fae0089d,91-9848693994,62,1,78,79,6,2,8
Indumati,ARRAN,Female,29-06-2005,indumati_arran_836@gmail.com,027cdd3c1739941143afd6e5470ed86a,91-8478868831,3,9,22,31,94,56,150
Esha,MAXEN,Female,25-03-2012,esha_127@gmail.com,4ec6b357e92777c5ef44807c44c45b5b,91-8212842877,21,4,8,12,81,1,82
Lavanya,MURSALEEN,Female,03-01-2005,lavanya_mursaleen@gmail.com,1a36e16e86bb04a6056daf02a8b68063,91-8688247926,64,4,2,6,8,5,13
Pundarik,W,Male,04-09-2007,w_627@gmail.com,e8402c2b0742d3ed71bc8f7da72eb50b,91-8342855859,82,9,4,13,5,55,60
ALEXIS,AARONVEER,Male,03-11-2005,alexis_357@gmail.com,a758f3df340b46de6a8cf78cce35afa7,91-8716596477,6,9,4,13,4,74,78
EDWIN,Y,Male,11-02-2010,edwin@yahoo.in,41fc6a9efccbf8f5f90a3f82a3ea53be,91-8897537951,21,3,4,7,91,27,118
Indraneel,JEHAN,Male,26-11-2012,jehan@gmail.com,99572164f373cdfe31197ef9b962c1d8,91-8241441471,39,9,6,15,6,29,35
Sunayana,Kamalakar,Female,12-10-2011,sunayana_kamalakar_931@gmail.com,148e9d259720575f0e3d82997ac60b49,91-7427769913,8,2,8,10,8,9,17
Manasi,Suprakash,Female,29-08-2005,manasi_suprakash@gmail.com,cbb3e75777579e483a0344d971927d52,91-9864127616,31,2,8,10,6,54,60
Neeharika,BEDE,Female,21-03-2005,neeharika_bede_856@gmail.com,d6ab135dabff3b53807af5e360d54320,91-7345373385,97,3,6,9,82,17,99
VINEET,NAGLIS,Male,05-04-2012,naglis@gmail.com,24d18cd7e971074051efe11c933b2710,91-8476996859,82,71,65,136,3,2,5
MASUM,E,Male,03-02-2008,masum@gmail.com,a9c2a50236c51a90029333252166240d,91-7374129679,6,73,1,74,43,29,72
JANEK,E,Male,2014-0-19,janek_e_564@gmail.com,7010c19dda81cd98c9282919014e8f81,91-8715635962,2,9,8,17,5,1,6
Shweta,MUAADH,Female,19-02-2006,shweta_muaadh_287@gmail.com,05d492a15eedd4fcbf014810eb558e92,91-8261198579,8,92,74,166,64,19,83
Sukumari,ALEKSS,Female,23-10-2014,sukumari_alekss_857@gmail.com,3aa51aeba798a4480f2cb532af4f0c0a,91-8335385163,7,3,4,7,1,23,24
Gandhali,K,Female,01-02-2009,gandhali_k_136@gmail.com,8ead82383ca3d9f7217817abfc0290ba,91-7118115799,73,74,13,87,48,6,54
ROMIE,ABHIRAM,Male,2007-0-12,romie_abhiram@gmail.com,80bb51195b4bf3d747f9ea13054f46b3,91-7484629847,81,71,6,77,2,4,6
Prasana,W,Female,30-03-2004,w@gmail.com,aee6c6b636f48b2ded24d379113471f9,91-8684379435,4,7,3,10,89,77,166
Amit,M,Male,2005-2-29,amit_m_724@gmail.com,6a9b08eea25141141de74144c7d62bf6,91-9943133323,54,5,37,42,49,69,118
ABDULLAH,FERRIS,Male,03-10-2009,ferris_142@yahoo.in,789971ecc5a4e068934dd44215564a69,91-7271634654,7,83,74,157,21,3,24
SHLOK,Anshumat,Male,03-03-2010,shlok_anshumat_673@gmail.com,504b25130d0bcaf8bcc44f08e5d23e46,91-7368148323,3,1,2,3,1,44,45
Deepashikha,A,Female,14-11-2006,a@gmail.com,296cae86e70cad247ba981fb3dea0151,91-7799156251,24,4,75,79,6,4,10
ADVAY,Dushyanta,Male,2009-0-2,advay_dushyanta@yahoo.in,ecc5e53f64e60a23e610f6f742557ee2,91-7362747353,4,55,37,92,8,6,14
Madhumati,Ranajay,Female,07-07-2011,madhumati_ranajay@yahoo.in,f6a23dba930c5b50edfe98582965afa8,91-9385984244,28,8,9,17,28,65,93
Raakhi,H,Female,16-08-2008,h_321@gmail.com,1be2501107220a4adeb254b18e915e4a,91-8273498591,9,82,53,135,56,52,108
FERDOUS,D,Male,03-04-2004,ferdous_d@gmail.com,f2fe16052cf6f02fd974e44dd6772a6e,91-8358983761,44,5,39,44,26,3,29
Susita,TALAL,Female,26-08-2007,susita_talal@gmail.com,5e4e859afde393b12f5452f09e95dee7,91-8384747336,6,47,58,105,52,3,55
Indiya,Vipra,Female,18-03-2012,indiya_vipra@gmail.com,4c2846ed8e7461e5b07ef7edaa7593a5,91-7644264571,9,27,86,113,15,95,110
Lavangi,X,Female,10-06-2014,x@gmail.com,6a4dd64481e7222e73fd521e784c54e0,91-7419372724,8,4,54,58,3,7,10
LOUAY,H,Male,11-01-2007,louay_h_746@yahoo.in,693b649e738f158e0b5e9a3aff906cbf,91-8642583159,9,4,58,62,9,4,13
Harithi,JADEN,Female,03-05-2012,jaden@gmail.com,4bc15acb6f006e78daa9774981016aa6,91-9837352316,8,4,8,12,4,7,11
Varana,G,Female,18-11-2005,varana_g_375@gmail.com,6d6a866ec9b95bdb345dc2979feb1ca8,91-9623169965,8,3,3,6,64,9,73
Pival,E,Female,22-03-2011,e_319@gmail.com,f52a350ee363f43ffe02cfe842a8afd5,91-7112882296,2,19,32,51,83,2,85
Basavaraj,C,Male,17-08-2012,basavaraj_c@gmail.com,e39399663846f9918c877bb56383d091,91-8284934153,53,57,2,59,15,4,19
Bibek,Vikesh,Male,10-09-2011,bibek_298@gmail.com,bc04f433da2d49f3f22caa30df60d952,91-8271837635,83,49,6,55,6,43,49
CHUKWUMA,D,Male,17-10-2005,chukwuma_d_647@gmail.com,b1ddfdbeed083bbd151da1148a547995,NA,0,0,0,0,0,0,0
Jaishree,MALACHY,Female,02-06-2006,jaishree_malachy@gmail.com,9f3004e00413a2f4238c36900efc4261,NA,0,0,0,0,0,0,0
Nitha,JEHIEL,Female,05-07-2011,nitha_917@gmail.com,324a33e344b2270ce73aad29735c014f,91-8187296597,11,23,51,74,1,9,10
Rudrani,Hemaraj,Female,26-08-2011,rudrani_hemaraj@gmail.com,000ced84f4f2ba9809bea2c5ebac766d,NA,0,0,0,0,0,0,0
BENNY,ODHRAN,Male,23-11-2013,benny_odhran_642@gmail.com,0e9f8ec87c72da0cf31ef831661dccba,91-8283653474,98,2,58,60,57,2,59
TORSTEN,Y,Male,18-02-2008,torsten_y_736@gmail.com,d71484862e86dbd3caa500e757ae95d7,91-7574817333,88,5,6,11,18,52,70
Kadhiroli,TYRION,Female,24-04-2010,kadhiroli_tyrion@yahoo.in,12dab2b0dfffb9de6cd3c333b36b116a,91-7953276536,29,2,5,7,61,3,64
Vasant,A,Male,03-10-2004,vasant_a@gmail.com,35ffd2362691712a547f0b4fbd56dc5d,91-7275271798,33,6,1,7,9,4,13
JALEN,KENZIE,Male,02-10-2007,jalen_kenzie@yahoo.in,1e0d9d256158df5b7b1f52e9c6cab04d,91-9417743832,91,5,2,7,8,21,29
Veer,Q,Male,19-03-2013,veer@gmail.com,b7e27225b6d99804b9f2e53e557f2b0b,91-7815169671,4,1,8,9,93,35,128
IDREES,V,Male,08-04-2012,idrees_v_726@gmail.com,dbf90daa7d1d69b08922f60a0fb14869,91-8749793972,2,71,42,113,68,2,70
Marala,Y,Female,29-03-2013,marala@gmail.com,880fb0144ae667d9cfc4c2c838d85d62,91-9149149127,32,56,2,58,56,2,58
Swarup,ECTOR,Male,04-08-2010,swarup_ector@yahoo.in,546f6ec84b8e36c3f14884c060e2df74,NA,0,0,0,0,0,0,0
Mangala,E,Female,26-09-2012,mangala@gmail.com,09cf7f8748f8ccb3e62e346f9b300540,91-7188914755,24,1,99,100,45,3,48
OCTAVIUS,Y,Male,29-06-2005,octavius_y@gmail.com,45e71473670d796cb19c0280679801e7,91-7627263452,6,8,6,14,43,82,125
Vineeta,KOLTON,Female,08-02-2010,kolton_564@gmail.com,adf899faa6795b8261f713132aba5729,91-8834242172,8,7,92,99,94,7,101
Shyamalima,PATRICK,Female,15-01-2012,shyamalima@gmail.com,33195aac365f9faa6849ca35538b8b8f,91-7799195562,86,81,61,142,51,62,113
Sulekh,BRODY,Female,2011-0-18,brody@gmail.com,26f53207cbefecf98501755a31729f98,91-7447876971,5,76,75,151,89,3,92
KAIYON,M,Male,2008-0-22,kaiyon_m_319@gmail.com,0103c8fd8acabad4b73f31441fbfed9a,91-7979975363,1,5,8,13,18,1,19
Sinsapa,A,Female,25-06-2009,sinsapa_a_843@gmail.com,ad10b341580ea03aba8e2db21a74c8ad,91-8476565652,4,32,32,64,93,59,152
Nilaya,JOHNJAMES,Female,21-08-2004,nilaya_johnjames@yahoo.in,361c830be459a9afd835a999285bbced,91-9414211745,46,36,1,37,51,31,82
RINALDS,KONNER,Male,23-07-2005,konner@yahoo.in,f2b0889f5e5764314483db8d9f1f93a6,91-7716976893,4,24,2,26,26,3,29
KOHEN,A,Male,19-05-2009,a@gmail.com,3733f25f457be754b68bd5d6903a9226,91-9272237933,9,3,44,47,95,98,193
Manprasad,RAJAN,Male,21-01-2012,manprasad_rajan@yahoo.in,c4c6a2f08c660427592f23b7d2da7c78,91-9894189699,19,2,3,5,6,1,7
Garati,F,Female,14-04-2008,garati_298@gmail.com,300d77ae7c5cb5f81eeb1a783e1428a4,91-8717494218,4,53,85,138,6,37,43
Vagdevi,C,Female,24-08-2011,vagdevi_c@gmail.com,eabd258c82c7481b10d2e9ca627bc6f5,91-8634352297,4,7,5,12,95,11,106
Shrestha,Itish,Female,03-01-2010,shrestha_itish_741@gmail.com,36786b056e3876aa52bb5b8508a02dd4,91-9639991952,21,18,7,25,46,4,50
Ekalavya,G,Male,02-05-2008,ekalavya@yahoo.in,0e80540a87c7f5fe95747dd67d30a36a,NA,0,0,0,0,0,0,0
Sriram,KEANE,Male,07-02-2006,sriram@gmail.com,9abf0e1c9af301d92025d4265d9c0350,91-7994723642,9,9,82,91,49,52,101
Saroja,Pariket,Female,14-11-2005,saroja_pariket_678@gmail.com,b625bacb7200a21419709d700e9c6857,91-9643773541,5,6,3,9,7,19,26
Kamna,KALE,Female,07-07-2008,kamna_kale_784@gmail.com,4978ba72b1f84edffa538e47e967cc5b,91-7667169488,78,3,8,11,45,5,50
ALFRED,MAHMOUD,Male,08-01-2012,mahmoud@gmail.com,7425c3da5e78bc95d766fe9d29c70727,NA,0,0,0,0,0,0,0
PARSA,ZARRAR,Male,15-06-2009,parsa_zarrar_567@gmail.com,ef43e4f8cdf0a63e603e80df46310f03,91-7234394543,27,54,4,58,45,5,50
Kushal,Japendra,Male,01-09-2011,kushal_japendra_918@gmail.com,6ee981d04e95099c21f50e2c88c5f4b6,NA,0,0,0,0,0,0,0
DuraiMurugan,U,Male,26-03-2011,duraimurugan_u@gmail.com,9de8f87b007f891ffc6e7a9a804f2bf8,91-9566645469,4,6,5,11,36,95,131
Sadgati,T,Female,01-11-2012,sadgati@gmail.com,1af5db99c788f352c0a73ffb94e4f212,91-7553941393,8,2,67,69,26,5,31
Fatimaor Fatma,D,Female,16-02-2005,d_521@gmail.com,b7f1583dda1ee05f8dfe5aa720c1ca70,91-9732142195,94,7,5,12,18,2,20
DHEVAN,Q,Male,04-05-2005,dhevan_358@gmail.com,c20a7a6cf2ca82706e616ff56c701370,91-9773764158,2,6,65,71,1,73,74
Kashi,TAKUMA,Female,05-03-2005,kashi_takuma@gmail.com,29d0fdbfdeb34af343ce5cdb070aedf4,91-8185348633,34,2,7,9,86,16,102
Padmajai,S,Female,11-07-2012,s@gmail.com,63cb3fc870d3e82b72184473944fd4e9,91-8898553443,38,8,5,13,9,2,11
Urja,I,Female,26-09-2012,urja_i_367@gmail.com,3c5b3c4325ba35e6eae03191af5101be,91-9595431436,89,4,6,10,7,56,63
HAYYAAN,Ratnakar,Male,03-09-2013,hayyaan_ratnakar_376@gmail.com,e4f44fc946e47d8869703a4b0d7db292,91-9914847448,72,59,7,66,2,3,5
Nidhyana,Sanchay,Female,17-02-2010,nidhyana_sanchay_836@gmail.com,109ab1e885a14156a26b116e7ccee227,91-8237184225,82,13,19,32,54,17,71
Sriya,CY,Female,21-11-2011,cy_692@gmail.com,d4f0bfa3d5bd22ee9ec7f7470cb166c5,91-7393686539,58,17,6,23,61,67,128
Leelamayee,RUSSELL,Female,13-02-2014,leelamayee_russell@gmail.com,ce88aef6d3a4ed6e581a0728ddbfdd00,91-7952144245,6,7,37,44,6,16,22
Samit,O,Female,03-03-2011,samit_o@gmail.com,0de3836535de13cd437087976d74f53a,91-9651959858,4,78,8,86,55,94,149
Leelamayee,G,Female,27-04-2007,leelamayee@gmail.com,ed89952aac9bfb1ed4249f1e856d0e53,91-9959117857,54,6,52,58,29,9,38
TYRONE,ADYAAN,Male,2012-0-27,tyrone_adyaan@gmail.com,5cd2f8c7bd59763cce3000338687fcaf,91-7577847799,62,1,89,90,7,21,28
Ahladita,R,Female,27-01-2008,ahladita_r@gmail.com,431f253425224ba0b562c34640066abe,91-9276317186,18,8,12,20,3,5,8
Ulupi,ATEEB,Female,25-02-2009,ulupi_ateeb_698@gmail.com,c3feb8fc7726bfce37130d827881c7a9,NA,0,0,0,0,0,0,0
Saphala,AHMAD,Female,07-09-2013,saphala_489@gmail.com,1e0a1b38d3de6bd5ccb6dfb4ba7479b1,91-9388186497,18,22,9,31,2,8,10
Kundan,Kashif,Female,13-01-2012,kashif@gmail.com,ffeecc212333c89f509a3f8cef6c998b,NA,0,0,0,0,0,0,0
Suneet,G,Male,19-10-2007,suneet_g_345@yahoo.in,7fecc9ec3eac9601d40a2abbf7ce5639,91-8448591942,11,83,82,165,18,8,26
Rolee,A,Female,03-04-2004,a@yahoo.in,86ec34a7850c936af32149120f324ac0,91-9187535365,29,23,5,28,52,77,129
Shreela,B,Female,11-08-2007,shreela_b@gmail.com,b324aaaeda5f3df59ea72d2e5e8489af,91-7988999298,95,48,1,49,2,6,8
GURSHAAN,W,Male,07-07-2008,gurshaan_952@yahoo.in,e9e2e1497f1e8089321662738a36981f,NA,0,0,0,0,0,0,0
Sankarshan,GURTEJ,Male,2007-0-2,sankarshan@gmail.com,e7b210be4f22950d81cb7921249daeb5,91-8445175619,5,6,4,10,31,57,88
Neeraja,JOSEF,Female,22-03-2009,neeraja_josef_597@yahoo.in,6f5480f4230fe334327c78833544b12c,91-7725165395,31,7,36,43,8,9,17
Dayamayee,W,Female,15-09-2008,w@gmail.com,fa1bcc0a15cd50a7ecf856af68675627,91-7756791161,3,1,58,59,3,5,8
MATISS,Q,Male,11-07-2009,matiss_q@gmail.com,7a0a616db2fff4717c6586632254c53d,91-7634738433,12,95,6,101,8,63,71
Shivlal,Jeevan,Male,09-10-2008,shivlal_jeevan@gmail.com,d04cb1b62539023239401f00c6ef47b6,91-9975915932,15,38,4,42,64,73,137
Usha,Chaman,Female,21-10-2012,usha@gmail.com,6fd78e61df05070acb87a9d163fffec2,91-7496937775,8,51,14,65,5,88,93
Shyamal,Yaduraj,Female,14-01-2013,shyamal_yaduraj@yahoo.in,2b454a315c6e956809bd6622316fbba2,91-7478875643,7,31,54,85,32,57,89
Pradeepta,T,Female,07-06-2008,t_196@yahoo.in,da15a0958e4ccd51af240f2656a0c719,91-7668378345,43,5,8,13,78,7,85
Akshita,M,Female,30-08-2013,akshita_m@yahoo.in,b2b52194ffdd5388d6ef27d815d629b3,91-7581163816,3,11,9,20,9,7,16
Haripriya,ROY,Female,19-04-2007,roy_948@gmail.com,0a93ef58f4d59d05989889db0772671d,91-8195397382,3,4,8,12,3,5,8
Mahijuba,EDIZ,Female,25-10-2004,mahijuba_ediz_193@gmail.com,adbf1fbe573d7536a18d74ada889cae6,91-8425295943,62,6,86,92,2,9,11
GERRARD,HABIB,Male,27-04-2011,gerrard_habib@gmail.com,8802fc3a3855d29ba0709f1ea98bb714,91-8449214141,34,2,7,9,55,81,136
ZAYYAN,M,Male,2014-0-10,zayyan_m@gmail.com,491e2f87115881c792d2e30f68532ac5,91-7678769237,2,9,31,40,52,6,58
Sharadindu,JOHNSON,Male,15-01-2011,johnson_519@gmail.com,e3b4087b26378f69031bede243a93ac4,91-7963364726,63,54,7,61,23,13,36
LEIGHTON-JAMES,GAGAN,Male,12-07-2009,leighton-james_gagan_842@yahoo.in,9d0c011f8b9b5652be673a4a61f18e0e,NA,0,0,0,0,0,0,0
Mrudani,V,Female,05-11-2009,mrudani_v_217@gmail.com,b468ee4a789ca8aa37f09f375fd4ac6d,91-8714358783,4,3,3,6,94,77,171
Janaki,X,Female,08-04-2012,janaki_x@gmail.com,e6996ef03d93cfc2725245d4227165b6,91-8593973712,4,37,1,38,7,42,49
ABDIKADIR,H,Male,09-11-2006,abdikadir_h@gmail.com,e9feb9d63ec2024face9e79a529dbf3d,91-8231555259,95,6,8,14,8,69,77
Lona,AARIS,Female,17-11-2013,aaris@gmail.com,44b9064c2723734c333c75f4c2a60cd6,91-9765628477,2,6,8,14,35,75,110
Anusha,Tejeshwar,Female,04-06-2008,anusha@gmail.com,4076c062b3c144cf47c0a9eab5858750,NA,0,0,0,0,0,0,0
Noorjehan,Nakul,Female,14-06-2009,noorjehan_nakul_372@gmail.com,3cb0300ebd39a55a832441736161e371,91-7745953496,6,6,69,75,9,51,60
Tula,DIETER,Male,19-04-2006,tula_dieter@gmail.com,a5c9f42215ebc8f40a13c6554be30a93,91-7876925467,7,3,74,77,19,66,85
Priti,A,Female,16-03-2012,priti_a_943@gmail.com,1769903d5ad4078e58c5dbd584d67e1b,91-7261744764,6,22,99,121,69,2,71
Gorochana,RONNIE,Female,28-11-2005,gorochana_ronnie@gmail.com,91d49c4132f6daed5db838895c47d15a,91-9328137963,44,8,83,91,3,2,5
Ina,ASTON-JAY,Female,01-08-2009,ina_aston-jay_156@gmail.com,0179cc52fe6f8fbf8aaca9b17e98a43a,91-7778988112,5,68,48,116,74,2,76
Ankitha,Buddhadev,Female,28-01-2009,buddhadev@yahoo.in,8ee40328fc443f6d9fb4b398c7d782ba,91-7773959864,2,48,56,104,45,79,124
Gopika,E,Female,26-02-2008,gopika_e@gmail.com,57d6f6b73ae8ac1e4fd8e4b1a68a1756,NA,0,0,0,0,0,0,0
Nishtha,F,Female,2013-2-30,nishtha_f_416@gmail.com,45391f79dd925d6dba0994716a4e0be6,91-9414942431,64,1,26,27,82,6,88
Marichi,Q,Female,13-07-2008,marichi_q@yahoo.in,22142ff3cf42abdfb99543ca092b4bf0,91-8416721339,96,46,1,47,25,12,37
KRRISH,RONAN,Male,23-03-2013,krrish_ronan@gmail.com,690f3a1a2cbb26b06c037810eed1d09a,91-7854976242,2,46,6,52,6,18,24
ERIK,SAMEER,Male,03-09-2006,erik_sameer@gmail.com,b131858cc81429a203b00fe33a0293a9,91-9915267293,94,1,99,100,94,73,167
KNIGHT,X,Male,07-03-2010,knight_x_897@gmail.com,ea3c4502c148061f34bfdc6031aebfee,91-7571753315,5,81,65,146,3,71,74
Dyutit,Bikram,Male,10-11-2014,dyutit_758@gmail.com,3ed6ee88b6278f01fd3ad0935e0bac14,91-7792336956,6,16,63,79,67,65,132
LEIGHTON,L,Male,06-09-2012,leighton_l_148@yahoo.in,20e09107a968f72f01424eb711c37291,91-8842253733,4,18,9,27,35,5,40
Shahid,Z,Male,29-10-2004,shahid_z_946@gmail.com,e693645d72195da85dd4009f96ef6002,91-7132345673,99,55,1,56,4,3,7
TAIT,WALEED,Male,30-09-2010,waleed@gmail.com,46f2f36216c27cfbce883631d0546e15,91-9654288982,1,75,88,163,3,87,90
Rajalakshmi,B,Female,21-10-2005,rajalakshmi_982@gmail.com,826345be1ffb1a5b0432ac65444635f4,91-8559815224,8,64,2,66,96,61,157
Apparajito,R,Male,13-06-2006,r_473@gmail.com,1143dd15e2adb72ea4df9a199c1c8869,91-8345353562,5,26,23,49,1,2,3
MUHAMMAD-UZAIR,Manth,Male,06-11-2008,muhammad-uzair_manth_276@yahoo.in,8139c1c66d9067bc60fa42a3e70d04b4,91-9246921184,6,48,51,99,5,1,6
ABDUL-HAKEEM,DAKOTA,Male,11-08-2013,dakota_369@yahoo.in,3757b4eb852738ff89f956e7dc223278,91-9338711583,44,9,88,97,96,28,124
Navnit,B,Male,2009-0-9,navnit_b_298@gmail.com,e02ded4c1e4bda251f18bd200a648608,91-8414998469,2,8,5,13,46,8,54
OLUWATAMILORE,KIEL,Male,11-07-2013,kiel_813@gmail.com,fe07a2793afcf057064c278e1d002976,91-7473871685,2,48,3,51,5,94,99
RIO-JAMES,D,Male,11-05-2004,d_714@gmail.com,0ea37b0898e194c0839accbb08e21ae4,91-7386837278,75,98,1,99,71,39,110
Archan,ARCHIBOLD,Female,26-10-2005,archan_archibold_962@gmail.com,064460b0f21edd2db128a9de328d0359,NA,0,0,0,0,0,0,0
Kamalakar,I,Male,02-07-2007,kamalakar_i_218@gmail.com,364bdbc3d66a3aef11a83b14ae5163a3,91-8617714844,65,2,54,56,3,27,30
FARIS,IOSIF,Male,18-03-2008,iosif@gmail.com,14b79ae4d302b2a14e217cac4589e5a0,91-7776728385,8,3,41,44,54,47,101
Kashif,JEEVUN,Male,2009-0-2,kashif_jeevun_982@gmail.com,576f51aa819df5060873258ecb7ae3f3,91-9868778965,9,61,83,144,46,62,108
Srikant,K,Male,02-09-2010,srikant_k_725@yahoo.in,6801ce6ff71c9a1822646df4cbe49317,91-9176367326,6,83,2,85,1,86,87
Anunitha,ESKIL,Female,30-08-2005,eskil@gmail.com,57cd11ff5f3e7130fc6e9f2f947a7b81,91-7338311767,1,7,79,86,9,9,18
SYRUS,T,Male,28-06-2013,syrus@gmail.com,8f1af5f3539660109b3f1da031ac3873,NA,0,0,0,0,0,0,0
Abhaya,ISSAC,Female,06-02-2006,abhaya_issac@yahoo.in,5195be40728b9b4206b4c3e5dc3990f0,91-8935647735,58,21,3,24,75,34,109
MARTON,KAILUM,Male,23-04-2009,kailum_197@gmail.com,d8366bc0ed816bdc9482814a7df13f3f,NA,0,0,0,0,0,0,0
Medini,G,Female,25-02-2007,medini@yahoo.in,8412e9c80a73094d75c9dddfc5793daa,91-7192313766,2,4,17,21,21,9,30
Kadambini,Nagarin,Female,03-08-2007,kadambini@yahoo.in,97a97865337290edea76c86041544922,NA,0,0,0,0,0,0,0
Suhela,JONAN,Female,23-10-2006,suhela_179@yahoo.in,95972cfc835f7621c5d21e81003aee99,91-7459479513,6,2,1,3,68,74,142
Snehin,P,Male,07-02-2013,snehin_p_719@gmail.com,32a55fff403eb37d05f67f95bb67dbc8,91-8788471571,17,3,9,12,2,1,3
Balachandra,NNAMDI,Male,2013-0-12,balachandra_nnamdi_315@gmail.com,dc18e83c82cff3afb335c1eaa4d6ffd3,91-9357388574,74,4,2,6,26,5,31
Sukumar,ERNIE,Male,15-01-2004,ernie_428@gmail.com,c75bb4444735361d29c346b9e6e47f78,91-7479379742,5,3,8,11,67,6,73
CHIMA,MALACHY,Male,23-09-2010,chima_malachy@gmail.com,126fd6eaa1eab3680a7f29be57579303,91-9285828834,5,35,61,96,43,6,49
VeeraSundari,Kapil,Female,2006-2-31,veerasundari_kapil@gmail.com,bc26a32d5fe2a3a2674988256b3d34bb,NA,0,0,0,0,0,0,0
TOBI,KIYAAN,Male,2008-2-31,kiyaan@yahoo.in,0a7601a83b9c83815db1c54e693a13f3,91-8155381412,64,1,57,58,8,6,14
Shakeela,Ratul,Female,15-08-2006,ratul_746@gmail.com,a46fb8129806aebf98e89d9fee9714c1,91-7769829113,51,2,3,5,9,8,17
Ishika,KAVARN,Female,03-10-2004,kavarn_961@yahoo.in,60d32c02f5e15cc462ed145c74032df8,91-8138733686,2,76,89,165,1,41,42
Suchitra,P,Female,12-10-2014,suchitra_p_835@gmail.com,393fa68a67b30336acb73fcaca1f5420,91-7599532958,7,68,23,91,2,73,75
Shrijani,M,Female,22-01-2012,shrijani_983@yahoo.in,97e01188d3734b36e7f6d64665af046f,91-9216771231,5,9,8,17,2,81,83
DONNIE,Thirugnanam,Male,28-02-2009,donnie_thirugnanam_679@gmail.com,595640d6ab956ef7462abcbb42699b49,91-7131775329,1,18,7,25,96,8,104
Jahanara,JAILEN,Female,10-02-2011,jahanara_jailen@gmail.com,267019f082cea90fe292b8df7d0cb800,91-9744879747,4,85,3,88,5,43,48
Bhavesh,G,Male,08-07-2009,bhavesh_476@gmail.com,70c3d7fc25e2cabce56965657b86528f,91-9723479888,83,8,1,9,5,58,63
FRASER,LA'KAI,Male,2012-0-15,fraser_574@yahoo.in,581a03a144304eec127ce12b9efc3650,91-8296999516,51,44,72,116,75,6,81
Mithil,D,Male,11-01-2006,mithil_612@gmail.com,171d6ad6d2052094c7e4d02953f05f55,91-7383561967,8,2,7,9,96,7,103
Amanda,P,Male,27-05-2006,amanda_895@yahoo.in,4e6556387ed30050c12910b26458349e,NA,0,0,0,0,0,0,0
Nikhita,RUDI,Female,14-04-2006,nikhita_rudi_527@gmail.com,e1d5b4fc0440128b03bc765b63dd6b46,91-7742198721,47,71,81,152,64,28,92
VLADISLAV,Manmohan,Male,31-07-2012,vladislav@gmail.com,642f3db8e8a3e2c0d0237e213a685127,91-9489198931,71,81,69,150,96,6,102
Avani,U,Female,21-11-2011,avani_846@gmail.com,f2b5d1f8fd9ac4aecdfe0383de5476d6,91-9899992263,55,2,15,17,25,8,33
LEWIS,DEAKON,Male,13-10-2006,deakon_893@gmail.com,8801d55cee61de07fa40bb55c17796e3,91-9436974466,8,95,69,164,85,68,153
Madhura,R,Female,10-09-2005,r_862@gmail.com,b58cb37ddc8dfbed5b10388f8b198e0e,91-7863716361,15,33,2,35,74,6,80
Ulhas,KODA,Male,23-11-2008,ulhas_943@gmail.com,1a49efd5c5909229c893906e76151ba6,91-8855971558,81,76,2,78,88,8,96
Tejal,S,Female,14-11-2008,tejal_s@yahoo.in,b330a1fa0c945621a44baf1b77bfba3d,91-7172547662,3,6,6,12,51,7,58
Naseen,KIANO,Female,05-01-2004,naseen@gmail.com,38aa0560f44a32fb6c695e60a364059e,91-7819569484,56,2,98,100,3,16,19
Fidaa,O,Male,13-06-2014,fidaa_o@gmail.com,63727887605b1f52728b3df0311d99b3,91-9575599931,8,5,47,52,1,6,7
KAI,Jaishankar,Male,01-08-2008,jaishankar_782@gmail.com,0197be2c61f819557715e39ac8552169,91-8971461483,9,7,86,93,8,3,11
Parama,Q,Female,17-04-2014,parama_q_741@gmail.com,1621c11555b1032c1dd4e0cb3d35866b,91-7117553933,56,58,66,124,6,17,23
Vasudhara,M,Female,2006-0-22,vasudhara_m_283@gmail.com,1368a2823a9c267d4b6edca0cd3b52de,NA,0,0,0,0,0,0,0
Ambarish,F,Male,26-07-2013,f_681@yahoo.in,7152cfce5e9b0cb2b43373d87b267ab6,91-7291322263,6,24,1,25,2,6,8
Jayashri,PRANSHU,Female,02-10-2008,jayashri@gmail.com,9c9e9090b6138c2f815751b5c66df67d,91-8339863314,49,5,24,29,12,5,17
Tejaswini,O,Female,02-10-2012,tejaswini_o@yahoo.in,0be668efa024d9ef44a81b991c6107f2,91-7278773841,92,5,7,12,6,7,13
Suryashankar,P,Male,19-03-2011,p@gmail.com,6f592cedf97ebbaf2c0a7321c2994d85,91-8538175572,8,41,6,47,3,8,11
Sarfaraz,PAVAN,Male,13-09-2005,pavan@gmail.com,2370b9e88ea7ffd2bdbb919d33034229,91-7994978283,17,25,4,29,5,91,96
DAVID,D,Male,17-06-2013,david_d@gmail.com,84e05ce4841a3aaea1bc0ca47d24a06d,91-9411269177,49,7,7,14,93,14,107
Chandravathi,ABDIASIS,Female,01-01-2009,abdiasis_298@gmail.com,3243b52a8d4a7208767ca5a2b04e314f,91-7293961422,3,1,8,9,4,78,82
Vinutha,SAMSON,Female,28-03-2007,vinutha_samson@gmail.com,899804131c9dc48a4e552a7946ebd263,NA,0,0,0,0,0,0,0
Trisha,OKAN,Female,16-11-2007,trisha_okan@gmail.com,ceadf5b032aeedb3a9fb495a495cd02c,91-9645719456,5,78,9,87,9,4,13
KAI,ARLAN,Male,11-02-2012,kai@gmail.com,7cedda248c90bb9e7dc5380a92446db5,91-8942636776,14,76,5,81,92,68,160
Anjushrior Anjushree,X,Female,04-01-2014,anjushrior anjushree_x@gmail.com,97bcb30ca9038e95fcc6ed471ce85c84,91-7345351441,4,6,9,15,32,74,106
Dhriti,BEN,Female,27-10-2011,dhriti_ben@gmail.com,9e69e9ca879341b314c0099a324d8aee,91-7446528744,52,86,27,113,93,34,127
TEILO,Z,Male,02-06-2012,z@gmail.com,6dc24e2c11c6d6e51df3311db93c9510,91-7655738982,3,2,3,5,9,59,68
Shrigauri,J,Female,2011-0-17,shrigauri_j@gmail.com,9c7fedc6551f70b3b7a91f02e6a946fc,91-7446529981,3,74,12,86,7,8,15
MUSTAFAA,B,Male,27-02-2010,mustafaa_b_852@gmail.com,87916ec1f1f8295c497994d1bab6d875,91-7193527824,8,6,97,103,26,21,47
Punamor Poonam,R,Female,18-07-2014,punamor poonam_r@gmail.com,1cc6b5c59f0203217c6aa9a5545301c0,91-7313594699,97,61,19,80,49,94,143
Kamini,Z,Female,03-11-2014,z_412@gmail.com,366f38487674ae8065e7992ac60fdd4f,91-9457932191,2,47,22,69,95,6,101
ZEB,SAFWAAN,Male,23-02-2004,safwaan@yahoo.in,853f993601b085cdd2f05036ac3e7786,91-8932681472,4,4,6,10,77,1,78
BOB,P,Male,27-05-2004,bob_582@gmail.com,0f85c8067bb59e3088fba13698981b71,91-7186413175,6,72,8,80,6,48,54
Kesar,Mansukh,Female,26-03-2008,kesar@yahoo.in,b64e5410e34586248482972669b0122c,91-9755559236,64,85,4,89,65,3,68
SAMET,ASHRAF,Male,2014-0-22,samet_815@gmail.com,e288593d6494531aa853abc1d8fe91bd,91-7996891816,58,46,74,120,8,9,17
Madhura,X,Female,2007-0-15,madhura_926@gmail.com,3b77aaa6a60fe5b0e6d5557409793883,91-8168525142,41,32,8,40,91,61,152
Sharada,ANAY,Female,2010-0-26,sharada_145@gmail.com,101995987830c2fa6b4f1793040abeb4,91-7584636338,9,26,89,115,56,73,129
AMARII,Q,Male,19-02-2008,amarii_q@gmail.com,82b3b9867720e68fc4ebd2476702b69f,91-9839526254,1,9,65,74,53,4,57
Aradhana,A,Female,10-09-2004,aradhana_a_138@gmail.com,7071d4cd8aaa70ec5fa31d752c57862b,91-8342968767,2,3,3,6,6,8,14
Eka,JAYDEN,Female,06-06-2011,eka_jayden_284@yahoo.in,923156ef1c35d8612cfdfa970985cdd0,91-7494633459,9,19,53,72,46,6,52
Manas,EDDY,Male,27-10-2013,manas@gmail.com,5c3b5f46be38d9b6eb4c20ede9bf1a66,91-8163757526,66,13,14,27,27,7,34
Dhithi,RANVIR,Female,15-11-2013,dhithi_ranvir@gmail.com,ce0120e189e6331c23bdf78228ea8c94,91-9899143187,89,2,7,9,1,4,5
Satyasheel,Angamuthu,Male,18-11-2009,satyasheel_297@gmail.com,a9dee96bd62b5d289266e21b9da987a0,91-9761755755,57,7,55,62,4,65,69
Gopika,U,Female,2004-4-31,gopika_651@gmail.com,b420ac295692a7ef1803985c59408d36,91-7182868866,2,88,8,96,6,36,42
FURKAN,Satyendra,Male,05-10-2011,furkan_satyendra_798@gmail.com,ae9cdee268d4f1b801ebb9c951e36c39,91-9581858996,12,8,6,14,9,18,27
Mridula,K,Female,01-09-2011,mridula_k@gmail.com,42536c57f4fd0a874e70108219df2730,91-8666546322,6,2,4,6,4,2,6
HAIDEN,O,Male,07-08-2011,haiden_o_573@gmail.com,0b93c1d52ceace6535bcac574454364e,91-9471924383,22,83,9,92,79,2,81
Manimala,Z,Female,20-02-2005,manimala_z_415@gmail.com,d5a4a1a4eeb044aa8adcdc4f3cbdd119,91-9479435881,9,42,54,96,98,1,99
Keshi,W,Female,26-06-2007,w_534@gmail.com,2d253b809154bbb1d6c232486acca740,91-7333671713,2,5,2,7,1,4,5
Nalin,W,Male,18-03-2006,nalin_w@gmail.com,b644705592207e2849cd6b00c3c7e59b,91-8221433638,78,83,67,150,18,75,93
Poornima,H,Female,29-07-2012,poornima_h@gmail.com,d4701bbd757387d92698b7d1daeced48,91-9947578956,4,6,2,8,9,6,15
TANISH,V,Male,12-08-2009,v_295@gmail.com,a8e46a832e3f51054e87a142c5dc75a7,91-7638445222,18,58,1,59,7,3,10
Parashuram,LU'AY,Male,26-05-2006,lu'ay@gmail.com,d395aeee224ceb52ba0eb51e5065a7bf,91-7558852784,95,92,9,101,98,2,100
JACQUES,O,Male,05-04-2011,o_619@gmail.com,34c2e809a078384eb5fd2749f9ff58e0,91-8811651989,69,57,61,118,67,36,103
SOHRAB,ZACKERY,Male,09-06-2013,sohrab_zackery@gmail.com,ca1612b5c87307e1612ec20d01694999,91-7686977124,9,27,3,30,91,23,114
RILEY-LEE,RAIHAAN,Male,27-02-2010,raihaan@gmail.com,1066ae2484f7619a9fec1ca5e1de0201,91-8712626223,2,7,9,16,8,4,12
Komal,LEO-JAMES,Female,25-02-2006,leo-james_476@gmail.com,c5bf486f7f6071fd3ca815cb1d970fa7,91-8666398387,9,97,45,142,9,12,21
ZAYN,I,Male,12-11-2005,zayn_i@gmail.com,02ee50e1d9072d882b98a1f7323bbecb,91-8489358821,84,31,4,35,2,8,10
Prashant,U,Male,04-05-2010,prashant@yahoo.in,f76094bf48733d82c9b3712be7df6cd1,NA,0,0,0,0,0,0,0
LUQMAN,S,Male,13-10-2014,s@gmail.com,0c7a2342907095ca151a1a2b0264f417,NA,0,0,0,0,0,0,0
Monisha,Q,Female,08-05-2010,monisha_q@gmail.com,23c70f7d5bfa9d63e1b7be19206f02bb,91-8554348792,91,7,89,96,1,51,52
Vari,JENSON-JAY,Female,29-09-2009,vari_456@gmail.com,f8b3662372e324a37e513c2e73e73121,91-8874313153,8,5,6,11,8,33,41
RADEK,MOHIT,Male,2006-0-10,mohit_435@gmail.com,fa93480a69c7cf93a020698d18c6cc99,NA,0,0,0,0,0,0,0
Pankaja,E,Female,19-09-2007,e_319@gmail.com,c491c90f9180080b11f416697a743188,91-9968865777,71,9,85,94,7,2,9
Agneya,ZIAD,Male,23-10-2013,agneya_ziad@gmail.com,71e567ceb78f076aad017845dd5c991f,NA,0,0,0,0,0,0,0
Bankimchandra,FREDERIK,Male,27-03-2009,bankimchandra@gmail.com,ab7c833bfae169fd5aa47c83bc8b1535,91-7196197459,15,59,4,63,8,93,101
Vanmala,R,Female,25-10-2008,vanmala_r@gmail.com,76127462e3374855f66c6839015738b8,91-7248256135,5,1,8,9,4,68,72
Gopior Gopika,Kamalesh,Female,06-10-2010,gopior gopika@gmail.com,d9d97e1a2581da5a5990aa1ef19369b6,NA,0,0,0,0,0,0,0
Dhitha,N,Female,14-04-2008,n_745@yahoo.in,bb9a81e369ad7f09aab1a1027273311b,NA,0,0,0,0,0,0,0
Utpala,T,Female,29-10-2008,utpala_t_621@gmail.com,f037ce779218547655cfb7629ab3c437,91-9451248684,21,2,67,69,94,8,102
KAZEEM,CHARLIE-JOHN,Male,09-10-2011,kazeem_charlie-john@gmail.com,67fc9725b0b39a647922b86b8c6bfbba,91-7332447122,32,91,12,103,4,3,7
REZWAN,N,Male,2006-0-3,rezwan@gmail.com,44942803f35c19361c6645ae95c16af0,91-9393224669,25,19,46,65,4,85,89
Vidyul,B,Female,19-06-2005,b_297@gmail.com,021b36f98ed8effc58a852a85587a8ee,91-8424614799,3,4,59,63,18,74,92
Naveena,O,Female,01-04-2005,naveena_o@gmail.com,f8f4fc7524d84657bae200fac91b47fc,91-7931369655,7,58,51,109,88,5,93
Somansh,R,Female,18-09-2011,somansh_r_621@gmail.com,491310222c608d5c91970f6330100d9c,91-8591692141,6,1,67,68,15,9,24
Bhairavi,A,Female,14-02-2007,bhairavi@gmail.com,fdc085c7250a1306c3aebf97c211a0ae,91-7353327487,75,1,4,5,73,6,79
Jharna,AMANDEEP,Female,2009-0-18,jharna_amandeep@yahoo.in,89412f4c8a07b0befa43d48fc5eaa895,91-7496365582,12,3,65,68,8,4,12
Mohana,AZIYAH,Female,09-07-2012,mohana_aziyah_461@gmail.com,25d8d9e6b2e3b7e1a100261e2158378b,91-9613544682,55,1,38,39,96,8,104
Sulabha,K,Female,2013-0-8,sulabha_k@yahoo.in,d8fed519f909a19d99ce42860acfbbc0,91-7712692393,66,4,26,30,78,2,80
THEO,T,Male,12-09-2011,theo@yahoo.in,e891fb5a17e300e60ab387e442193431,91-7543157667,55,3,32,35,98,5,103
Aruni,T,Female,04-04-2009,aruni_t_931@gmail.com,dfbd2fb8e91af6b24a7e7455c768c8d3,91-7816867343,9,4,89,93,18,59,77
Reshmi,K,Female,11-08-2005,reshmi_k_351@gmail.com,dbb28f288d07f2eb182a677060692fc3,91-8525549621,9,92,7,99,81,7,88
ANTONI,Tuhinsurra,Male,28-01-2013,antoni_tuhinsurra@gmail.com,bc1aaba9f3a51c772faecd30a1fe1bb6,91-7951351971,1,14,11,25,71,89,160
STEWIE,KARAMVEER,Male,29-05-2005,stewie@gmail.com,5acb4450477ad424fe1b20c8661df928,91-7176853682,6,8,3,11,34,98,132
Ambu,O,Female,2006-0-5,ambu_o@gmail.com,b4feb8ab9968cf06eb9d4f21a2a85dad,91-7752742185,5,7,4,11,9,8,17
DEVRAN,I,Male,23-05-2013,i@yahoo.in,054d14e32c1ebf3133b84fa00c0e6d79,91-8341965165,59,8,3,11,68,87,155
Inesh,Jagmohan,Male,21-01-2009,inesh_465@gmail.com,f6b802017bc0b618be144c08e4240e0b,91-7666521838,5,65,9,74,98,9,107
Sampada,C,Female,18-09-2011,sampada@gmail.com,b91d0705b5cef371595688521fca539c,91-7271945666,2,81,5,86,4,8,12
Manjulika,GYAAN,Female,02-10-2010,manjulika_gyaan@gmail.com,8f332f0a689da8fd9a6ea1dec7dd32e9,NA,0,0,0,0,0,0,0
Subhan,LEROY,Male,13-03-2006,subhan_leroy@gmail.com,aa54f192bc783a4f97133d5f695f21a2,91-8871567881,9,21,9,30,32,1,33
Phanindra,KIAH,Male,22-09-2013,phanindra_kiah@gmail.com,bdcdf0b4cb2804decb19ee6416dd6cf1,91-8595959378,5,51,1,52,27,31,58
WAARIS,Shravankumar,Male,24-10-2005,waaris@gmail.com,8fe96bf643bfcac896932d5b740c91dd,91-7143264312,3,4,3,7,48,6,54
Kapardini,N,Female,21-05-2006,kapardini@gmail.com,f3dfefbb87ed86228052ab9c1aedc086,91-7165266162,8,4,85,89,6,2,8
Shakambari,Anangaor Anang ,Female,23-02-2005,shakambari_anangaor anang @yahoo.in,7df32bf03fd87617ad3192d4b802d82b,91-7266718749,1,2,97,99,96,5,101
Dakshakanya,JEEVUN,Female,05-02-2008,jeevun_368@gmail.com,1f9de7154a91471eafb7c0ab5c4b4c68,91-9627485332,2,74,2,76,17,95,112
Yuthika,ETHAN-JAMES,Female,2011-9-31,yuthika_ethan-james_726@gmail.com,eb4b88afd28fc56b20d02e5893f7c055,91-7898539716,26,9,1,10,62,9,71
Shankari,W,Female,01-09-2009,shankari_w_237@gmail.com,7ce11d9b72c803ff58ae4be31ff84af5,91-8767367111,24,67,13,80,55,4,59
Amba,MATHIAS,Female,2011-0-10,amba_mathias_329@gmail.com,50a559f5ebd794764a88c4e38d22ab81,91-7876937512,36,5,7,12,8,3,11
ALVARO,ELIYAS,Male,25-04-2008,alvaro_518@gmail.com,5505cce511eb81b8739a06bb4ac54739,91-7779495591,35,87,69,156,65,21,86
Neeharika,AVNISH,Female,08-05-2008,avnish_128@yahoo.in,ac3c1d3fe7a0cff0c0e3e5f3b8eeab17,91-7411998233,2,15,3,18,75,28,103
Hemavati,ABDUL-,Female,24-11-2009,abdul-_439@yahoo.in,76cbffc409b536f407de2e55731c1dd6,91-8458884572,23,12,26,38,27,62,89
Manjari,I,Female,2008-0-28,i_196@gmail.com,6b3cc71c914f45797e384c7684e1a9e5,91-7979256673,44,8,86,94,98,1,99
Lajjawati,F,Female,12-11-2004,lajjawati_f_148@gmail.com,b807735fc10031480fd16f0ac3036c8a,91-7464927323,1,8,81,89,26,95,121
Sadhya,WOLFGANG,Female,2013-0-26,wolfgang_173@gmail.com,5ca7795505696925c956ae699ba18ef4,91-7213985786,3,93,9,102,8,5,13
HAYDON,A,Male,23-07-2008,haydon_a@gmail.com,30f37a572c62985c9b19a3b250b7122b,NA,0,0,0,0,0,0,0
OLIVER-JACK,HARLEY-JOE,Male,03-11-2012,harley-joe_162@yahoo.in,80ebf4c56503549d00f71a59e3323b8c,NA,0,0,0,0,0,0,0
Devyani,M,Female,04-07-2004,devyani_m@gmail.com,ef74798abed5048b67553a35497c4188,NA,0,0,0,0,0,0,0
ARAIZ,W,Male,07-05-2007,araiz_637@gmail.com,914f33c762286a6f0c016ba74c2e4361,NA,0,0,0,0,0,0,0
JIMMY-LEE,S,Male,15-04-2010,jimmy-lee_s@yahoo.in,cc4f5a295b6ef4c938f068230c1904d0,91-7243151416,5,51,6,57,5,5,10
ASIF,G,Male,26-05-2010,asif@gmail.com,b98017d54ab6b5e8acdd51abc242c0c2,91-7549621933,39,51,47,98,8,9,17
Shubhra,G,Female,07-01-2009,shubhra_g@yahoo.in,c8dd9e478eb71d53940cd7ce04c71ec3,91-8462918617,1,9,9,18,56,15,71
Harshvardhan,Jalindra,Male,28-09-2011,harshvardhan_jalindra@yahoo.in,34cf5e33f7a5381b64be8710871ad753,91-7294543719,4,76,2,78,83,6,89
STORM,W,Male,12-02-2004,storm_w@gmail.com,d19133b9d997f27e6f8f5863a4563679,91-9922755937,8,9,2,11,49,17,66
